PaymentID,LoanID,AmountPaid,PaymentDate,RemainingBalance
1,1,129761.72,2025-09-30,354275.81
2,1,89065.7,2026-08-03,265210.11
3,1,70164.89,2029-02-16,195045.22
4,1,18084.23,2031-10-17,176960.99
5,1,15742.52,2032-06-06,161218.47
6,1,42234.67,2033-09-01,118983.8
7,2,31490.41,2023-10-21,117990.66
8,2,22249.16,2024-09-25,95741.5
9,2,16867.08,2026-02-14,78874.42
10,2,12083.97,2026-09-14,66790.45
11,2,17385.7,2027-01-18,49404.75
12,3,13122.27,2025-04-08,78745.61
13,3,6719.92,2025-04-14,72025.69
14,3,14487.9,2025-05-18,57537.79
15,3,10514.49,2025-06-23,47023.3
16,3,5831.38,2025-07-17,41191.92
17,3,6049.34,2025-09-09,35142.58
18,3,8839.58,2025-09-15,26303.0
19,3,4071.38,2025-09-17,22231.62
20,3,5012.59,2025-10-16,17219.03
21,3,1112.54,2026-01-18,16106.49
22,4,22048.71,2022-12-11,55368.73
23,4,5780.13,2023-06-30,49588.6
24,4,13057.41,2030-01-18,36531.19
25,5,30646.02,2024-02-02,237510.62
26,5,58591.17,2024-08-31,178919.45
27,5,33238.6,2025-02-27,145680.85
28,5,18054.13,2025-05-26,127626.72
29,5,35793.39,2025-06-27,91833.33
30,5,18891.97,2026-02-09,72941.36
31,5,12670.48,2026-05-27,60270.88
32,5,16902.54,2026-10-29,43368.34
33,5,11953.35,2028-05-19,31414.99
34,6,34568.46,2023-07-09,193856.09
35,6,33821.34,2025-04-01,160034.75
36,6,27120.07,2025-12-11,132914.68
37,7,54669.66,2023-03-07,216731.18
38,7,38666.78,2025-06-10,178064.4
39,7,34171.58,2027-01-02,143892.82
40,7,26268.61,2029-08-14,117624.21
41,7,11385.87,2029-10-08,106238.34
42,7,21458.73,2031-06-25,84779.61
43,7,7405.28,2031-12-26,77374.33
44,7,7579.17,2032-09-10,69795.16
45,8,74276.18,2025-04-05,363217.13
46,8,97205.74,2025-09-17,266011.39
47,8,26290.04,2028-06-18,239721.35
48,8,63730.99,2028-07-08,175990.36
49,8,27373.24,2030-03-26,148617.12
50,8,32785.08,2032-07-07,115832.04
51,8,16139.45,2032-12-02,99692.59
52,9,1406.7,2026-07-08,13925.43
53,9,1705.94,2028-06-22,12219.49
54,9,2682.6,2028-08-06,9536.89
55,9,2519.73,2029-01-20,7017.16
56,9,893.32,2029-07-01,6123.84
57,9,741.77,2030-06-16,5382.07
58,10,6253.5,2022-11-28,117484.45
59,10,11863.91,2022-12-07,105620.54
60,10,23586.84,2022-12-26,82033.7
61,10,24412.34,2022-12-31,57621.36
62,10,12365.75,2023-01-03,45255.61
63,10,9162.62,2023-03-23,36092.99
64,10,6722.15,2023-05-24,29370.84
65,10,7088.35,2023-06-04,22282.49
66,11,85437.07,2022-07-23,299950.43
67,11,58160.52,2023-01-04,241789.91
68,11,44021.66,2024-06-20,197768.25
69,11,17705.87,2024-09-01,180062.38
70,11,31924.86,2025-03-05,148137.52
71,11,18085.0,2026-09-21,130052.52
72,11,35094.95,2027-06-23,94957.57
73,11,9251.52,2028-12-16,85706.05
74,12,16157.22,2022-01-30,45886.27
75,12,7151.32,2022-05-28,38734.95
76,12,2759.51,2023-05-23,35975.44
77,12,8401.31,2023-07-06,27574.13
78,12,5404.08,2024-01-21,22170.05
79,12,1406.05,2025-07-14,20764.0
80,12,2693.11,2026-02-01,18070.89
81,12,2450.62,2026-03-07,15620.27
82,12,4062.88,2027-12-30,11557.39
83,12,3145.96,2031-05-29,8411.43
84,13,12640.18,2022-09-20,66812.74
85,13,14873.63,2022-09-21,51939.11
86,13,14267.45,2023-01-17,37671.66
87,13,2188.69,2023-06-20,35482.97
88,13,3565.96,2026-01-30,31917.01
89,13,1792.37,2026-11-20,30124.64
90,13,5148.34,2027-03-02,24976.3
91,13,3664.14,2027-09-07,21312.16
92,13,3771.15,2027-09-15,17541.01
93,13,944.49,2029-06-27,16596.52
94,14,50382.05,2027-01-17,242311.66
95,14,38465.71,2028-05-31,203845.95
96,14,41042.73,2028-09-15,162803.22
97,14,35983.18,2030-03-28,126820.04
98,15,116810.22,2023-06-07,358263.89
99,15,61362.34,2029-07-07,296901.55
100,15,39052.39,2029-07-22,257849.16
101,15,20324.4,2031-05-06,237524.76
102,16,487.93,2022-07-14,8815.39
103,16,639.36,2024-07-26,8176.03
104,16,2364.99,2026-03-30,5811.04
105,16,1563.67,2026-07-22,4247.37
106,16,858.59,2027-06-13,3388.78
107,17,101971.27,2021-05-12,293401.65
108,17,17702.05,2025-01-03,275699.6
109,17,14471.01,2026-02-23,261228.59
110,18,20188.43,2025-01-09,71867.24
111,18,12205.15,2026-05-05,59662.09
112,18,9755.7,2026-07-16,49906.39
113,18,4829.38,2027-08-24,45077.01
114,18,4358.38,2027-11-16,40718.63
115,18,2122.52,2028-06-18,38596.11
116,19,23724.46,2024-05-27,127701.62
117,19,10610.47,2025-03-26,117091.15
118,19,7896.29,2025-06-23,109194.86
119,19,23703.93,2026-08-11,85490.93
120,19,7512.46,2027-04-02,77978.47
121,19,9901.91,2027-12-10,68076.56
122,19,18605.54,2029-04-15,49471.02
123,20,8919.48,2025-04-21,35693.47
124,20,5438.25,2025-08-15,30255.22
125,20,6147.22,2025-12-01,24108.0
126,20,4360.26,2027-08-23,19747.74
127,20,1102.03,2028-02-09,18645.71
128,20,5098.67,2028-03-05,13547.04
129,20,3242.7,2030-07-19,10304.34
130,21,4337.13,2021-10-17,20007.13
131,21,3713.48,2022-02-02,16293.65
132,21,2207.08,2022-08-06,14086.57
133,21,954.51,2022-12-28,13132.06
134,21,955.81,2023-09-14,12176.25
135,21,1567.2,2023-09-15,10609.05
136,21,2607.75,2024-01-29,8001.3
137,21,839.81,2024-02-23,7161.49
138,21,2112.78,2025-08-09,5048.71
139,21,661.68,2025-12-03,4387.03
140,22,13660.47,2021-10-07,112726.11
141,22,32435.76,2023-01-11,80290.35
142,22,18213.46,2023-10-08,62076.89
143,22,15433.84,2024-01-12,46643.05
144,22,11475.19,2025-01-06,35167.86
145,22,7608.3,2026-04-16,27559.56
146,22,5029.99,2027-09-04,22529.57
147,22,6354.89,2028-02-04,16174.68
148,22,823.52,2030-08-28,15351.16
149,22,3067.39,2031-08-04,12283.77
150,23,7606.0,2022-04-24,47229.03
151,23,11164.39,2022-05-09,36064.64
152,23,3967.9,2023-06-16,32096.74
153,23,3167.61,2023-06-17,28929.13
154,23,4497.01,2023-08-13,24432.12
155,23,2477.37,2023-12-31,21954.75
156,23,1816.18,2024-03-24,20138.57
157,23,5338.88,2024-08-27,14799.69
158,23,931.91,2025-01-27,13867.78
159,23,1285.07,2025-01-30,12582.71
160,24,63279.47,2023-02-07,319364.45
161,24,39587.93,2023-08-08,279776.52
162,24,81962.69,2023-10-05,197813.83
163,24,34756.67,2024-07-11,163057.16
164,25,7406.39,2021-11-24,21865.13
165,25,5261.34,2022-02-15,16603.79
166,25,4875.69,2023-02-03,11728.1
167,25,1327.57,2024-08-13,10400.53
168,25,777.57,2024-12-27,9622.96
169,25,1142.06,2025-09-22,8480.9
170,25,888.89,2027-01-20,7592.01
171,25,1157.19,2027-12-08,6434.82
172,25,1694.28,2028-04-11,4740.54
173,25,1162.87,2031-06-07,3577.67
174,26,8735.94,2023-05-27,39957.08
175,26,6381.01,2023-09-06,33576.07
176,26,9081.82,2023-09-11,24494.25
177,26,7197.98,2024-02-22,17296.27
178,26,4524.96,2025-12-07,12771.31
179,26,2958.4,2025-12-19,9812.91
180,27,87292.56,2025-03-14,271705.21
181,27,65035.27,2027-04-14,206669.94
182,27,51354.29,2027-07-06,155315.65
183,27,37180.57,2027-10-21,118135.08
184,27,8269.38,2028-09-28,109865.7
185,27,11100.07,2030-03-18,98765.63
186,27,19446.6,2031-01-15,79319.03
187,27,13506.51,2032-04-07,65812.52
188,27,16460.23,2032-07-22,49352.29
189,27,9093.22,2032-11-08,40259.07
190,28,837.16,2026-01-10,15859.86
191,28,3383.78,2026-05-11,12476.08
192,28,2770.6,2026-09-09,9705.48
193,28,1189.28,2026-10-09,8516.2
194,28,829.91,2026-11-16,7686.29
195,28,1517.07,2027-04-02,6169.22
196,29,66129.69,2025-01-18,205067.41
197,29,49544.09,2025-05-01,155523.32
198,29,42466.89,2025-08-27,113056.43
199,30,17211.99,2021-10-14,45207.62
200,30,9189.6,2022-04-29,36018.02
201,30,7838.45,2022-12-22,28179.57
202,30,2023.26,2023-02-08,26156.31
203,30,1535.83,2023-12-30,24620.48
204,30,7204.76,2024-08-30,17415.72
205,31,56984.71,2023-12-19,195211.29
206,31,56837.54,2025-05-30,138373.75
207,31,13126.78,2026-04-18,125246.97
208,31,27566.62,2027-01-17,97680.35
209,31,4893.93,2028-09-03,92786.42
210,31,12391.86,2029-05-09,80394.56
211,31,9998.35,2030-12-23,70396.21
212,31,9292.27,2031-08-03,61103.94
213,32,19822.55,2022-08-15,301392.62
214,32,86291.06,2022-09-10,215101.56
215,32,63035.66,2022-10-04,152065.9
216,32,31702.97,2024-02-08,120362.93
217,32,32835.14,2024-04-18,87527.79
218,32,18294.69,2024-05-21,69233.1
219,32,20077.08,2024-08-13,49156.02
220,32,10278.55,2026-01-18,38877.47
221,32,6602.1,2026-03-26,32275.37
222,33,13557.44,2025-03-17,205428.83
223,33,12377.83,2025-07-27,193051.0
224,33,14166.31,2025-12-05,178884.69
225,33,53285.36,2027-08-15,125599.33
226,34,12010.63,2024-10-10,223651.11
227,34,34259.44,2025-03-17,189391.67
228,34,17592.21,2025-03-31,171799.46
229,34,41208.29,2026-02-18,130591.17
230,34,14270.86,2027-04-11,116320.31
231,34,22388.08,2027-07-07,93932.23
232,35,35435.13,2021-06-18,88534.41
233,35,11963.78,2021-07-28,76570.63
234,35,21826.34,2021-07-28,54744.29
235,36,35589.77,2023-05-25,306143.95
236,36,60960.72,2023-12-27,245183.23
237,36,71097.7,2024-08-31,174085.53
238,36,17562.51,2030-01-02,156523.02
239,37,46583.32,2024-02-16,208775.02
240,37,31851.52,2024-12-14,176923.5
241,37,24721.6,2028-04-02,152201.9
242,37,40897.55,2028-09-21,111304.35
243,38,11130.02,2030-08-05,168853.4
244,38,17858.36,2032-01-11,150995.04
245,38,38178.32,2032-08-29,112816.72
246,39,23119.77,2021-10-04,174496.47
247,39,27901.98,2023-01-04,146594.49
248,39,29978.42,2025-12-13,116616.07
249,40,24842.77,2021-10-21,66302.77
250,40,9575.98,2023-04-26,56726.79
251,40,15502.8,2023-07-02,41223.99
252,40,8980.89,2023-09-11,32243.1
253,40,4677.85,2024-01-20,27565.25
254,40,8141.58,2024-06-22,19423.67
255,40,1822.57,2025-06-17,17601.1
256,40,1575.04,2026-03-18,16026.06
257,41,53880.95,2025-01-26,197577.68
258,41,14577.8,2025-12-06,182999.88
259,41,17907.21,2026-07-17,165092.67
260,41,11484.71,2027-01-28,153607.96
261,42,114025.4,2025-10-30,322051.03
262,42,90330.76,2026-02-20,231720.27
263,42,68934.89,2026-06-12,162785.38
264,42,14632.69,2028-01-30,148152.69
265,42,8940.67,2028-10-08,139212.02
266,42,12340.14,2029-12-10,126871.88
267,42,7282.31,2030-09-21,119589.57
268,42,15751.24,2030-11-17,103838.33
269,42,16394.19,2031-01-15,87444.14
270,43,104800.13,2023-05-31,302676.37
271,43,52255.19,2024-08-08,250421.18
272,43,52515.14,2026-04-01,197906.04
273,44,11296.96,2023-11-21,80152.31
274,44,22676.38,2024-03-22,57475.93
275,44,5406.75,2024-04-03,52069.18
276,44,2627.42,2024-04-09,49441.76
277,44,5713.01,2024-04-28,43728.75
278,44,11115.01,2025-09-14,32613.74
279,44,6052.88,2025-10-09,26560.86
280,44,5890.11,2026-01-23,20670.75
281,44,4307.31,2026-05-26,16363.44
282,45,17510.45,2025-02-12,147843.43
283,45,42843.76,2026-11-26,104999.67
284,45,8761.92,2027-02-26,96237.75
285,45,13483.21,2027-03-30,82754.54
286,45,7932.03,2028-04-26,74822.51
287,45,20693.79,2029-03-18,54128.72
288,46,45171.94,2023-02-17,202288.07
289,46,56220.14,2024-01-29,146067.93
290,46,42548.37,2024-04-18,103519.56
291,46,24674.24,2024-05-11,78845.32
292,46,6996.02,2024-08-07,71849.3
293,46,20186.62,2024-08-17,51662.68
294,46,11723.26,2025-01-02,39939.42
295,46,6395.63,2026-08-13,33543.79
296,47,2581.75,2024-10-08,6052.73
297,47,1114.0,2028-01-15,4938.73
298,47,1181.46,2030-10-30,3757.27
299,47,831.75,2032-05-05,2925.52
300,48,57687.55,2024-12-09,400106.85
301,48,99951.89,2025-12-29,300154.96
302,48,42813.94,2026-01-28,257341.02
303,48,30646.14,2026-11-09,226694.88
304,48,17525.92,2029-08-22,209168.96
305,48,10694.94,2029-10-25,198474.02
306,49,36489.68,2022-09-09,195093.31
307,49,44890.93,2025-02-03,150202.38
308,49,9666.12,2025-02-21,140536.26
309,49,16528.87,2026-04-23,124007.39
310,49,22551.2,2029-06-06,101456.19
311,50,12102.45,2026-12-25,56831.38
312,50,13867.81,2027-06-29,42963.57
313,50,11289.24,2028-02-16,31674.33
314,50,4850.17,2028-08-03,26824.16
315,50,3024.66,2029-09-08,23799.5
316,51,5967.35,2027-01-30,104439.87
317,51,17918.05,2032-05-08,86521.82
318,51,7594.99,2033-03-03,78926.83
319,51,11005.39,2034-03-27,67921.44
320,52,32132.34,2024-02-19,200692.57
321,52,49140.64,2027-02-01,151551.93
322,52,8384.81,2028-07-22,143167.12
323,53,39080.63,2025-06-26,321504.89
324,53,72497.27,2026-02-01,249007.62
325,53,45134.83,2026-03-23,203872.79
326,53,38900.79,2026-05-22,164972.0
327,53,36232.68,2027-03-07,128739.32
328,53,20158.89,2027-08-30,108580.43
329,53,9456.7,2027-12-19,99123.73
330,53,27995.63,2028-01-28,71128.1
331,54,83559.59,2028-05-10,309235.46
332,54,63423.3,2029-03-01,245812.16
333,54,35707.31,2031-04-21,210104.85
334,55,18332.71,2023-11-07,201240.44
335,55,37262.79,2024-02-18,163977.65
336,55,48977.81,2024-03-12,114999.84
337,55,20046.68,2024-04-10,94953.16
338,56,17857.89,2023-08-28,90166.44
339,56,17462.37,2027-07-22,72704.07
340,56,8863.78,2028-05-14,63840.29
341,56,9428.81,2029-01-28,54411.48
342,57,78219.34,2025-06-24,372082.45
343,57,61554.55,2025-07-02,310527.9
344,57,22940.95,2025-07-26,287586.95
345,57,57523.76,2025-08-31,230063.19
346,57,28149.27,2025-11-01,201913.92
347,57,46848.28,2026-01-16,155065.64
348,58,118578.21,2025-04-20,283816.2
349,58,67996.28,2025-12-16,215819.92
350,58,27199.84,2028-02-04,188620.08
351,58,48473.36,2028-09-04,140146.72
352,59,13527.14,2024-01-02,235839.37
353,59,67525.28,2024-01-28,168314.09
354,59,48264.29,2024-01-28,120049.8
355,59,17114.44,2024-05-29,102935.36
356,60,31330.56,2024-10-14,150400.82
357,60,35822.59,2024-11-07,114578.23
358,60,16458.76,2024-11-17,98119.47
359,60,24633.07,2025-08-18,73486.4
360,60,12660.75,2026-06-24,60825.65
361,60,13956.4,2026-09-23,46869.25
362,60,10609.41,2028-10-31,36259.84
363,60,10524.6,2029-12-05,25735.24
364,61,17033.43,2021-04-22,59695.02
365,61,12526.58,2022-08-11,47168.44
366,61,10247.09,2023-12-07,36921.35
367,61,11064.74,2024-07-11,25856.61
368,61,7357.71,2024-12-24,18498.9
369,61,3033.3,2025-03-24,15465.6
370,61,1597.8,2025-05-29,13867.8
371,61,1071.28,2027-04-26,12796.52
372,61,2944.49,2027-05-25,9852.03
373,62,118406.92,2022-08-09,294452.41
374,62,68170.46,2022-08-13,226281.95
375,62,19504.95,2022-10-10,206777.0
376,62,54081.92,2022-12-17,152695.08
377,62,39457.06,2023-02-24,113238.02
378,62,11149.76,2023-03-07,102088.26
379,62,21276.46,2023-04-07,80811.8
380,62,21177.5,2023-04-17,59634.3
381,62,14571.43,2023-06-29,45062.87
382,63,6598.27,2024-03-22,116376.67
383,63,32400.56,2024-07-29,83976.11
384,63,16178.12,2026-09-11,67797.99
385,63,4512.96,2027-01-24,63285.03
386,63,4812.97,2027-11-09,58472.06
387,63,12938.94,2028-11-07,45533.12
388,63,5730.74,2029-10-23,39802.38
389,63,11230.29,2030-03-28,28572.09
390,63,3650.65,2031-05-13,24921.44
391,64,37619.31,2021-12-10,421747.93
392,64,41074.09,2022-04-30,380673.84
393,64,61095.43,2022-06-15,319578.41
394,65,66242.24,2023-07-19,239138.05
395,65,29331.68,2023-08-23,209806.37
396,65,28647.6,2023-09-11,181158.77
397,65,16850.96,2024-01-26,164307.81
398,65,31274.59,2024-06-09,133033.22
399,65,29481.52,2024-11-14,103551.7
400,65,8998.58,2024-12-21,94553.12
401,66,79632.59,2022-03-14,246189.2
402,66,19855.54,2023-08-30,226333.66
403,66,33867.1,2023-11-04,192466.56
404,67,1752.05,2021-10-31,19192.89
405,67,5444.48,2022-02-14,13748.41
406,67,2974.97,2022-05-09,10773.44
407,67,1745.3,2022-06-09,9028.14
408,67,2682.99,2022-11-16,6345.15
409,67,370.59,2024-09-27,5974.56
410,67,1481.33,2025-02-11,4493.23
411,68,63752.65,2024-07-19,208050.72
412,68,51099.44,2026-04-07,156951.28
413,68,14232.42,2026-07-26,142718.86
414,68,11322.72,2026-10-05,131396.14
415,68,25093.53,2027-12-24,106302.61
416,68,7902.62,2028-04-22,98399.99
417,69,10556.31,2022-06-19,126585.21
418,69,11212.01,2022-07-24,115373.2
419,69,10581.92,2022-09-24,104791.28
420,69,12148.72,2023-01-13,92642.56
421,69,26252.22,2023-02-19,66390.34
422,69,17974.0,2029-01-13,48416.34
423,70,3234.56,2021-02-11,48093.24
424,70,12042.91,2021-03-09,36050.33
425,70,4339.82,2021-03-11,31710.51
426,70,7875.91,2021-04-12,23834.6
427,70,2732.25,2021-06-02,21102.35
428,70,4901.01,2021-07-02,16201.34
429,70,3782.19,2021-07-19,12419.15
430,70,2765.03,2021-10-20,9654.12
431,71,52136.95,2027-06-15,271056.3
432,71,19992.73,2029-04-23,251063.57
433,71,18685.27,2029-09-13,232378.3
434,71,57736.11,2030-04-23,174642.19
435,71,48059.69,2030-05-01,126582.5
436,71,22998.15,2030-12-20,103584.35
437,71,24303.59,2031-01-07,79280.76
438,71,22371.24,2031-02-17,56909.52
439,72,113218.34,2023-12-30,315751.15
440,72,58706.42,2024-05-03,257044.73
441,72,54136.04,2024-07-09,202908.69
442,72,48643.89,2024-10-07,154264.8
443,72,21110.39,2025-03-30,133154.41
444,72,29633.95,2025-04-11,103520.46
445,72,20974.64,2025-07-11,82545.82
446,72,22886.4,2025-12-06,59659.42
447,72,3409.39,2026-03-14,56250.03
448,72,16180.21,2026-03-16,40069.82
449,73,43939.15,2023-08-22,256196.82
450,73,60916.97,2024-12-10,195279.85
451,73,53947.23,2025-04-03,141332.62
452,73,19903.25,2026-03-28,121429.37
453,73,21715.41,2026-04-18,99713.96
454,73,23449.89,2026-05-30,76264.07
455,73,20117.78,2027-07-28,56146.29
456,73,13855.34,2028-07-10,42290.95
457,73,5170.28,2029-06-30,37120.67
458,74,48055.2,2023-12-05,226126.46
459,74,31725.04,2024-10-23,194401.42
460,74,14412.27,2027-10-10,179989.15
461,74,28739.81,2027-12-18,151249.34
462,74,8899.69,2028-12-10,142349.65
463,74,10809.64,2032-02-17,131540.01
464,75,34004.3,2022-03-03,135433.76
465,75,40391.5,2023-08-17,95042.26
466,75,27956.47,2023-12-18,67085.79
467,75,11727.16,2025-04-26,55358.63
468,75,3265.26,2027-04-08,52093.37
469,76,11916.53,2023-06-20,32204.67
470,76,8000.13,2025-09-12,24204.54
471,76,3909.21,2026-01-01,20295.33
472,76,4194.76,2026-02-03,16100.57
473,76,3072.55,2026-03-05,13028.02
474,76,3635.14,2026-06-05,9392.88
475,76,506.59,2027-01-07,8886.29
476,76,2252.39,2027-03-31,6633.9
477,76,447.93,2028-09-08,6185.97
478,77,39712.93,2025-07-17,270874.34
479,77,23113.58,2025-12-07,247760.76
480,77,31205.5,2026-11-30,216555.26
481,78,137386.94,2025-01-17,334114.8
482,78,49197.04,2025-06-01,284917.76
483,78,23773.9,2025-07-23,261143.86
484,78,17172.59,2026-07-18,243971.27
485,78,63708.22,2026-08-05,180263.05
486,78,16760.25,2026-11-21,163502.8
487,78,11985.41,2026-11-26,151517.39
488,79,72267.06,2022-11-21,328874.77
489,79,30140.33,2023-01-20,298734.44
490,79,60441.48,2023-02-21,238292.96
491,79,56336.83,2024-01-31,181956.13
492,79,38699.87,2024-03-15,143256.26
493,80,26489.6,2023-10-30,117504.54
494,80,14661.45,2026-03-21,102843.09
495,80,26823.13,2026-11-18,76019.96
496,80,7442.07,2027-01-16,68577.89
497,80,7137.68,2028-01-19,61440.21
498,80,11870.89,2028-02-27,49569.32
499,81,39294.46,2022-01-01,351950.4
500,81,40439.19,2022-01-28,311511.21
501,81,41050.38,2022-02-22,270460.83
502,82,34510.74,2020-11-28,120367.55
503,82,34455.18,2021-07-12,85912.37
504,82,24076.0,2022-07-04,61836.37
505,82,15722.91,2023-04-07,46113.46
506,82,9406.97,2023-08-01,36706.49
507,83,87011.85,2024-06-01,376018.69
508,83,102654.77,2025-02-07,273363.92
509,83,47193.25,2025-09-14,226170.67
510,83,50973.31,2027-04-26,175197.36
511,83,22241.94,2028-01-24,152955.42
512,83,41461.66,2030-10-24,111493.76
513,84,74292.47,2026-10-01,268815.91
514,84,55449.67,2027-07-26,213366.24
515,84,53244.74,2027-08-30,160121.5
516,84,29791.57,2027-10-30,130329.93
517,84,22208.67,2027-11-06,108121.26
518,84,30352.68,2027-11-30,77768.58
519,84,14558.28,2028-06-14,63210.3
520,85,104847.83,2021-09-03,341764.65
521,85,59222.52,2021-09-26,282542.13
522,85,84681.9,2021-11-20,197860.23
523,85,12132.39,2022-01-11,185727.84
524,85,15501.36,2022-01-31,170226.48
525,85,35795.87,2022-02-15,134430.61
526,85,33760.59,2022-02-20,100670.02
527,85,23928.93,2022-05-08,76741.09
528,85,21320.2,2022-06-11,55420.89
529,85,11104.78,2022-06-25,44316.11
530,86,113628.03,2024-07-12,293595.16
531,86,69488.2,2024-07-28,224106.96
532,86,24453.7,2025-02-11,199653.26
533,86,13395.61,2025-04-13,186257.65
534,86,46970.42,2025-05-06,139287.23
535,86,26973.79,2025-08-24,112313.44
536,86,19996.35,2025-12-18,92317.09
537,86,26671.1,2026-08-06,65645.99
538,86,13153.02,2026-10-13,52492.97
539,86,2658.32,2027-08-25,49834.65
540,87,109769.14,2023-12-13,348597.99
541,87,25601.6,2024-01-30,322996.39
542,87,36687.68,2028-01-03,286308.71
543,87,62750.42,2029-05-13,223558.29
544,88,26759.77,2025-07-11,165589.96
545,88,25502.83,2026-10-30,140087.13
546,88,29628.35,2027-10-25,110458.78
547,88,8097.63,2027-11-10,102361.15
548,88,27807.59,2029-07-24,74553.56
549,88,7144.33,2030-05-12,67409.23
550,89,77851.54,2023-04-25,272213.49
551,89,46152.37,2023-11-24,226061.12
552,89,23844.49,2024-05-26,202216.63
553,89,54978.24,2025-08-15,147238.39
554,90,97030.85,2021-02-24,279211.17
555,90,36788.18,2022-12-24,242422.99
556,90,50730.62,2023-01-11,191692.37
557,90,54547.01,2023-03-12,137145.36
558,90,37891.45,2023-04-07,99253.91
559,91,130787.79,2023-11-19,365048.03
560,91,77439.25,2024-02-23,287608.78
561,91,61675.22,2024-07-21,225933.56
562,91,12347.88,2024-12-02,213585.68
563,91,24695.38,2025-06-18,188890.3
564,91,16618.0,2025-07-08,172272.3
565,91,21343.34,2025-10-06,150928.96
566,91,8777.09,2025-11-20,142151.87
567,91,29235.8,2025-12-08,112916.07
568,92,91647.4,2028-08-16,363350.45
569,92,76249.9,2029-04-27,287100.55
570,92,18586.34,2030-01-30,268514.21
571,93,35379.1,2024-08-03,451867.4
572,93,48442.41,2025-12-11,403424.99
573,93,51151.03,2027-08-31,352273.96
574,94,3332.88,2024-07-12,16811.48
575,94,884.67,2024-11-28,15926.81
576,94,2560.51,2025-01-08,13366.3
577,94,1153.94,2026-07-14,12212.36
578,95,123368.52,2023-01-18,290531.48
579,95,46016.25,2023-02-19,244515.23
580,95,57953.93,2023-07-17,186561.3
581,95,21858.47,2024-02-17,164702.83
582,95,40738.46,2024-07-30,123964.37
583,95,10287.98,2025-05-22,113676.39
584,95,15458.49,2026-07-09,98217.9
585,95,14174.07,2027-07-03,84043.83
586,95,24143.07,2028-11-26,59900.76
587,96,30212.89,2021-08-27,106891.19
588,96,20377.22,2022-01-26,86513.97
589,96,8751.37,2022-07-22,77762.6
590,96,18713.8,2022-09-27,59048.8
591,96,9256.54,2023-05-06,49792.26
592,96,14444.67,2024-03-05,35347.59
593,96,5945.26,2024-03-31,29402.33
594,96,4261.5,2026-05-22,25140.83
595,97,15136.5,2026-08-06,89179.58
596,97,26232.82,2029-04-07,62946.76
597,97,12192.55,2030-08-12,50754.21
598,98,28655.82,2020-11-06,238251.82
599,98,24573.86,2021-01-06,213677.96
600,98,35699.76,2021-06-14,177978.2
601,98,42351.34,2021-10-08,135626.86
602,98,33858.12,2023-03-20,101768.74
603,98,28294.87,2023-06-27,73473.87
604,99,86471.81,2022-12-27,239673.63
605,99,17362.53,2022-12-27,222311.1
606,99,26450.18,2023-03-10,195860.92
607,99,24364.43,2023-06-15,171496.49
608,99,24431.94,2023-06-30,147064.55
609,99,16985.32,2023-07-31,130079.23
610,99,17773.28,2023-10-15,112305.95
611,100,19996.91,2025-10-18,248802.44
612,100,52163.22,2029-08-11,196639.22
613,100,39404.32,2029-10-12,157234.9
614,100,37595.88,2029-11-02,119639.02
615,101,33865.45,2024-07-28,237283.67
616,101,67383.93,2024-10-17,169899.74
617,101,25779.37,2025-02-28,144120.37
618,101,24519.9,2025-04-25,119600.47
619,101,29287.82,2025-05-18,90312.65
620,101,21818.79,2025-06-09,68493.86
621,101,15777.17,2026-05-25,52716.69
622,101,6296.6,2026-10-05,46420.09
623,102,40512.13,2024-02-13,401670.2
624,102,64937.29,2024-02-15,336732.91
625,102,25969.08,2024-03-22,310763.83
626,103,43329.74,2023-08-18,313305.28
627,103,42375.28,2023-10-17,270930.0
628,103,66524.13,2024-08-21,204405.87
629,103,48771.12,2025-05-24,155634.75
630,103,35748.4,2025-05-25,119886.35
631,103,11177.34,2025-09-02,108709.01
632,103,19822.45,2025-09-11,88886.56
633,103,24750.12,2026-12-11,64136.44
634,103,6266.34,2027-01-12,57870.1
635,104,59825.27,2021-10-16,337036.51
636,104,70541.32,2023-06-21,266495.19
637,104,44266.96,2023-07-30,222228.23
638,104,57626.92,2024-01-26,164601.31
639,104,48792.58,2024-04-02,115808.73
640,104,28368.09,2026-05-20,87440.64
641,104,11023.15,2027-06-04,76417.49
642,104,4819.7,2027-11-07,71597.79
643,104,20856.01,2027-11-29,50741.78
644,104,2785.42,2029-03-08,47956.36
645,105,54615.5,2026-02-02,196893.45
646,105,22438.84,2026-07-29,174454.61
647,105,32754.81,2027-08-25,141699.8
648,105,7175.66,2027-09-14,134524.14
649,105,7883.28,2028-01-28,126640.86
650,106,857.21,2022-06-06,11931.8
651,106,3092.48,2023-07-17,8839.32
652,106,750.88,2023-07-25,8088.44
653,106,607.28,2023-08-11,7481.16
654,106,497.04,2023-11-20,6984.12
655,106,451.13,2024-02-03,6532.99
656,106,804.84,2024-09-13,5728.15
657,106,565.96,2025-06-25,5162.19
658,106,1010.49,2026-11-28,4151.7
659,107,8546.13,2022-01-29,144764.06
660,107,41234.84,2022-06-14,103529.22
661,107,19906.92,2022-11-19,83622.3
662,107,9052.86,2022-12-14,74569.44
663,107,19914.53,2024-01-20,54654.91
664,107,4392.94,2025-01-17,50261.97
665,107,4722.29,2025-03-16,45539.68
666,108,14746.16,2021-11-02,177087.05
667,108,28785.94,2023-03-10,148301.11
668,108,28375.29,2024-06-13,119925.82
669,109,21324.87,2021-03-19,151084.43
670,109,17818.9,2023-01-28,133265.53
671,109,38911.18,2023-06-06,94354.35
672,109,7193.8,2025-05-01,87160.55
673,109,15887.18,2027-04-23,71273.37
674,109,14155.11,2027-07-24,57118.26
675,109,16843.34,2028-12-28,40274.92
676,110,25016.71,2026-04-01,271516.86
677,110,62381.8,2029-05-24,209135.06
678,110,22676.39,2029-11-19,186458.67
679,110,46839.55,2032-03-08,139619.12
680,110,24848.88,2033-11-08,114770.24
681,110,6036.81,2034-07-25,108733.43
682,111,5014.4,2021-10-07,42226.69
683,111,5246.0,2025-06-28,36980.69
684,111,10644.86,2025-09-19,26335.83
685,111,3257.98,2026-07-03,23077.85
686,111,6696.26,2027-12-05,16381.59
687,111,3201.64,2028-05-29,13179.95
688,111,2155.64,2028-06-25,11024.31
689,111,1665.4,2028-07-31,9358.91
690,111,2471.34,2028-12-05,6887.57
691,111,368.33,2029-11-29,6519.24
692,112,63535.29,2022-04-07,230063.82
693,112,42548.99,2022-05-07,187514.83
694,112,48898.08,2022-11-01,138616.75
695,112,39460.85,2022-12-27,99155.9
696,112,14007.16,2023-01-16,85148.74
697,112,7398.05,2023-10-04,77750.69
698,113,26700.14,2024-08-25,345257.65
699,113,71710.84,2026-04-04,273546.81
700,113,52718.99,2026-09-19,220827.82
701,113,62334.36,2030-10-13,158493.46
702,113,23348.52,2031-07-19,135144.94
703,113,26730.64,2031-09-18,108414.3
704,114,7367.23,2021-07-10,33284.79
705,114,4804.19,2023-05-28,28480.6
706,114,6111.18,2023-06-03,22369.42
707,114,5674.5,2024-02-12,16694.92
708,114,4984.99,2024-06-08,11709.93
709,114,2366.05,2024-10-21,9343.88
710,114,500.61,2024-12-12,8843.27
711,115,12374.4,2025-12-14,113643.54
712,115,23358.1,2026-07-24,90285.44
713,115,22799.16,2028-11-04,67486.28
714,115,9319.4,2029-07-29,58166.88
715,115,5041.63,2031-07-02,53125.25
716,115,13007.09,2031-09-01,40118.16
717,116,50350.3,2026-03-13,220763.74
718,116,16672.12,2029-09-11,204091.62
719,116,56915.94,2029-10-22,147175.68
720,116,10660.67,2029-12-05,136515.01
721,116,25968.76,2030-06-09,110546.25
722,117,42874.95,2023-09-30,267395.11
723,117,61584.79,2024-03-15,205810.32
724,117,36779.97,2025-08-13,169030.35
725,118,50983.3,2022-04-14,430908.32
726,118,101930.12,2023-06-14,328978.2
727,118,57545.75,2024-05-10,271432.45
728,119,4444.55,2024-08-11,37627.45
729,119,7312.19,2024-11-13,30315.26
730,119,2913.63,2028-01-12,27401.63
731,119,3965.67,2028-07-29,23435.96
732,119,1991.57,2029-04-11,21444.39
733,119,5086.57,2031-08-19,16357.82
734,120,16828.87,2020-11-30,74656.74
735,120,21151.77,2023-12-17,53504.97
736,120,11741.13,2025-05-23,41763.84
737,120,2929.39,2025-06-10,38834.45
738,120,8928.94,2026-04-04,29905.51
739,120,3014.53,2026-05-06,26890.98
740,120,7572.58,2026-07-21,19318.4
741,120,1336.83,2027-07-23,17981.57
742,121,29857.96,2026-04-07,93973.49
743,121,5052.62,2026-06-25,88920.87
744,121,22956.75,2027-03-18,65964.12
745,121,15344.25,2027-05-31,50619.87
746,121,9956.37,2030-10-13,40663.5
747,122,82178.67,2021-07-15,262380.97
748,122,56523.9,2021-08-17,205857.07
749,122,61409.54,2021-09-02,144447.53
750,122,24577.58,2021-11-14,119869.95
751,122,27718.49,2021-12-14,92151.46
752,122,6130.35,2021-12-21,86021.11
753,122,5755.66,2022-01-31,80265.45
754,123,34521.11,2023-10-19,248558.87
755,123,18194.49,2023-11-20,230364.38
756,123,55314.41,2023-12-15,175049.97
757,123,42254.75,2027-12-04,132795.22
758,123,11839.58,2029-03-26,120955.64
759,123,35182.98,2029-07-03,85772.66
760,124,15865.4,2025-05-02,193769.86
761,124,51227.02,2025-10-11,142542.84
762,124,19200.89,2026-01-15,123341.95
763,124,9038.67,2026-03-09,114303.28
764,124,32061.39,2026-06-20,82241.89
765,124,14274.66,2026-06-26,67967.23
766,124,18383.4,2026-08-27,49583.83
767,124,11030.97,2027-10-08,38552.86
768,124,8462.39,2028-01-10,30090.47
769,125,30123.58,2027-06-20,86352.21
770,125,17596.87,2027-07-16,68755.34
771,125,5705.76,2029-02-23,63049.58
772,125,8073.08,2033-02-12,54976.5
773,126,32144.21,2025-04-08,313141.72
774,126,76922.85,2025-08-31,236218.87
775,126,53024.13,2025-12-13,183194.74
776,126,50254.0,2027-05-31,132940.74
777,126,27412.86,2028-03-04,105527.88
778,126,5464.18,2028-05-28,100063.7
779,126,11487.77,2028-12-25,88575.93
780,126,17674.4,2029-01-12,70901.53
781,126,4200.72,2031-06-05,66700.81
782,127,31862.92,2022-04-14,200508.25
783,127,18647.3,2023-03-04,181860.95
784,127,17561.9,2023-11-16,164299.05
785,127,13827.16,2023-12-03,150471.89
786,127,25018.83,2024-09-28,125453.06
787,127,10926.74,2024-10-19,114526.32
788,127,18683.24,2025-06-17,95843.08
789,127,24553.24,2025-07-13,71289.84
790,128,46884.73,2024-09-18,152165.43
791,128,14762.41,2024-10-12,137403.02
792,128,24499.49,2025-03-28,112903.53
793,128,8002.38,2025-04-18,104901.15
794,128,13418.84,2025-08-18,91482.31
795,128,19065.15,2025-11-09,72417.16
796,128,19254.48,2026-04-13,53162.68
797,128,13494.86,2027-09-18,39667.82
798,128,2848.8,2028-09-04,36819.02
799,128,7121.68,2029-01-07,29697.34
800,129,12680.67,2023-06-19,54377.77
801,129,12030.7,2023-08-03,42347.07
802,129,10158.04,2023-12-02,32189.03
803,129,3998.15,2023-12-04,28190.88
804,129,5204.01,2023-12-16,22986.87
805,129,2665.3,2023-12-29,20321.57
806,129,2726.99,2024-01-01,17594.58
807,129,4881.41,2024-01-03,12713.17
808,130,5838.66,2025-08-25,58470.4
809,130,15878.52,2025-08-28,42591.88
810,130,8364.94,2025-11-12,34226.94
811,130,4269.73,2026-11-08,29957.21
812,130,3657.65,2027-07-11,26299.56
813,131,29242.12,2023-05-17,467198.71
814,131,31310.68,2023-12-31,435888.03
815,131,110784.29,2024-06-07,325103.74
816,131,81494.95,2025-04-12,243608.79
817,131,31049.87,2025-09-22,212558.92
818,131,54638.54,2028-02-17,157920.38
819,131,17076.22,2029-01-12,140844.16
820,131,20353.52,2030-06-20,120490.64
821,132,3263.66,2023-09-04,35189.88
822,132,3392.83,2023-09-25,31797.05
823,132,4892.92,2024-01-14,26904.13
824,132,3589.43,2024-05-20,23314.7
825,133,146837.45,2024-11-12,352238.2
826,133,69683.99,2025-02-24,282554.21
827,133,15632.2,2025-04-21,266922.01
828,133,24550.93,2027-03-30,242371.08
829,133,57535.1,2027-10-13,184835.98
830,134,49220.57,2022-09-25,139356.02
831,134,37420.23,2023-01-23,101935.79
832,134,13167.14,2024-01-01,88768.65
833,134,5593.05,2024-11-15,83175.6
834,134,12977.53,2026-06-04,70198.07
835,134,6990.63,2026-07-10,63207.44
836,135,46479.12,2023-06-16,131886.81
837,135,20094.62,2024-08-23,111792.19
838,135,18118.72,2024-11-18,93673.47
839,135,20902.89,2024-12-12,72770.58
840,135,11144.0,2028-04-11,61626.58
841,136,120345.57,2024-08-05,296685.61
842,136,72217.57,2026-04-24,224468.04
843,136,41830.8,2027-10-12,182637.24
844,136,25093.78,2028-04-12,157543.46
845,137,44133.98,2023-01-23,304046.5
846,137,71882.31,2023-04-04,232164.19
847,137,17524.84,2023-12-13,214639.35
848,137,47528.8,2023-12-17,167110.55
849,137,21137.06,2024-04-10,145973.49
850,137,33133.51,2024-08-14,112839.98
851,137,14937.36,2024-09-08,97902.62
852,137,9466.53,2025-06-18,88436.09
853,137,15168.09,2025-09-30,73268.0
854,137,15834.86,2025-10-12,57433.14
855,138,55941.1,2021-04-24,248354.99
856,138,54389.43,2021-06-03,193965.56
857,138,56330.88,2021-10-24,137634.68
858,138,33724.97,2021-12-27,103909.71
859,138,7794.99,2022-02-17,96114.72
860,138,11301.44,2022-03-05,84813.28
861,138,4783.9,2022-05-03,80029.38
862,138,5359.63,2022-07-18,74669.75
863,138,8794.55,2023-03-25,65875.2
864,139,63025.21,2024-02-06,429997.84
865,139,40655.12,2024-08-10,389342.72
866,139,29769.87,2026-10-23,359572.85
867,139,37022.35,2026-10-27,322550.5
868,139,85046.3,2027-01-17,237504.2
869,139,19170.73,2029-07-23,218333.47
870,139,35251.85,2029-11-02,183081.62
871,139,32175.68,2029-12-13,150905.94
872,139,34192.07,2031-06-14,116713.87
873,139,15868.88,2031-12-14,100844.99
874,140,92572.79,2021-04-10,378326.08
875,140,28110.41,2022-03-21,350215.67
876,140,34277.15,2025-05-23,315938.52
877,140,27627.84,2025-06-14,288310.68
878,141,42264.7,2022-04-19,142200.37
879,141,39145.84,2024-08-12,103054.53
880,141,18232.89,2025-01-22,84821.64
881,141,14725.43,2025-06-08,70096.21
882,141,11301.45,2025-06-25,58794.76
883,141,11772.08,2025-10-18,47022.68
884,141,9301.65,2026-02-22,37721.03
885,142,43030.74,2022-08-03,371945.59
886,142,27695.85,2022-09-02,344249.74
887,142,67586.13,2023-07-22,276663.61
888,142,24008.39,2023-11-17,252655.22
889,142,59276.34,2024-09-28,193378.88
890,142,54359.06,2027-02-28,139019.82
891,143,22914.26,2021-04-27,137283.75
892,143,35285.42,2022-04-11,101998.33
893,143,21865.92,2023-07-12,80132.41
894,143,12233.27,2024-07-05,67899.14
895,144,26579.12,2024-03-16,216121.98
896,144,57512.17,2024-06-25,158609.81
897,144,13725.89,2026-04-24,144883.92
898,144,27753.0,2026-09-13,117130.92
899,145,129751.48,2024-01-09,335708.58
900,145,39919.99,2025-01-13,295788.59
901,145,23396.57,2025-04-16,272392.02
902,145,32917.88,2025-10-03,239474.14
903,145,15580.42,2025-10-04,223893.72
904,145,27773.42,2026-02-23,196120.3
905,145,13687.25,2026-07-18,182433.05
906,146,98813.87,2024-08-08,367420.93
907,146,43336.7,2024-10-31,324084.23
908,146,36246.46,2024-11-07,287837.77
909,146,17739.94,2024-11-20,270097.83
910,147,2135.64,2027-01-16,10896.22
911,147,2567.41,2027-02-21,8328.81
912,147,1352.87,2027-06-17,6975.94
913,148,56443.43,2024-03-05,382294.53
914,148,72057.82,2024-12-16,310236.71
915,148,41035.96,2025-04-23,269200.75
916,148,33464.72,2025-07-05,235736.03
917,149,38589.6,2020-09-05,259099.76
918,149,73545.97,2022-09-17,185553.79
919,149,26120.49,2025-05-03,159433.3
920,149,27664.39,2025-06-30,131768.91
921,150,44810.36,2023-02-10,229521.82
922,150,25935.1,2024-08-21,203586.72
923,150,52641.69,2024-11-18,150945.03
924,150,33188.13,2025-04-17,117756.9
925,150,19234.47,2025-09-28,98522.43
926,150,16672.15,2026-09-17,81850.28
927,150,9938.11,2027-09-22,71912.17
928,150,8927.37,2027-11-03,62984.8
929,150,6598.61,2027-11-08,56386.19
930,151,27742.76,2021-02-15,171769.16
931,151,51024.47,2021-05-22,120744.69
932,151,21421.8,2021-06-03,99322.89
933,151,23561.01,2021-08-30,75761.88
934,151,18855.25,2021-09-25,56906.63
935,151,14025.18,2022-05-18,42881.45
936,151,3306.07,2022-09-11,39575.38
937,151,8427.28,2022-10-13,31148.1
938,151,4134.47,2023-01-25,27013.63
939,151,2606.9,2023-05-24,24406.73
940,152,63908.4,2023-10-02,375562.82
941,152,105493.27,2024-02-07,270069.55
942,152,38978.81,2027-06-27,231090.74
943,152,39113.62,2027-12-20,191977.12
944,153,84337.15,2023-07-16,270413.22
945,153,38986.73,2025-03-19,231426.49
946,153,67770.7,2027-10-15,163655.79
947,153,29847.81,2029-07-24,133807.98
948,153,11284.31,2030-09-21,122523.67
949,153,11221.51,2031-06-28,111302.16
950,154,32826.2,2026-01-24,104957.96
951,154,12903.21,2028-09-11,92054.75
952,154,25359.09,2031-03-12,66695.66
953,154,17038.06,2034-01-23,49657.6
954,155,31687.9,2021-10-20,101822.78
955,155,7540.05,2022-01-05,94282.73
956,155,13380.19,2023-09-03,80902.54
957,155,23574.88,2024-06-23,57327.66
958,155,14748.9,2025-03-24,42578.76
959,155,4314.59,2025-12-12,38264.17
960,155,2662.18,2026-12-03,35601.99
961,155,6289.62,2027-01-06,29312.37
962,155,5280.86,2028-07-17,24031.51
963,155,4557.48,2029-04-19,19474.03
964,156,55625.24,2024-05-26,188434.54
965,156,52189.62,2024-06-19,136244.92
966,156,20263.66,2026-03-07,115981.26
967,156,14156.44,2026-03-10,101824.82
968,156,24654.49,2026-06-16,77170.33
969,156,17449.77,2026-08-16,59720.56
970,156,4380.56,2027-02-26,55340.0
971,156,3830.58,2028-08-17,51509.42
972,157,30023.93,2021-10-28,86503.34
973,157,11042.87,2022-05-27,75460.47
974,157,19160.6,2022-07-29,56299.87
975,157,4005.92,2024-06-09,52293.95
976,157,5284.31,2025-12-07,47009.64
977,158,91244.58,2024-01-22,343876.57
978,158,27190.6,2025-02-24,316685.97
979,158,32141.43,2025-09-12,284544.54
980,159,107594.59,2023-06-08,299137.67
981,159,76392.62,2029-07-03,222745.05
982,159,52409.04,2030-04-05,170336.01
983,160,5216.77,2023-07-17,43124.76
984,160,8200.82,2025-11-13,34923.94
985,160,2907.92,2025-11-16,32016.02
986,160,5289.78,2027-09-16,26726.24
987,161,61672.29,2023-09-23,187898.29
988,161,52855.95,2023-10-30,135042.34
989,161,28782.6,2024-03-15,106259.74
990,161,24480.59,2026-11-20,81779.15
991,162,58424.81,2023-02-06,239437.11
992,162,58881.18,2024-01-13,180555.93
993,162,23568.01,2024-02-03,156987.92
994,162,35333.51,2024-02-28,121654.41
995,162,15759.82,2024-05-29,105894.59
996,162,20757.31,2024-10-03,85137.28
997,162,11906.59,2025-04-17,73230.69
998,162,12495.57,2025-08-28,60735.12
999,162,15357.01,2025-10-09,45378.11
1000,162,12250.25,2026-04-04,33127.86
1001,163,42505.66,2023-12-30,174451.91
1002,163,28453.11,2024-01-13,145998.8
1003,163,21793.9,2025-03-30,124204.9
1004,163,29296.42,2025-05-09,94908.48
1005,163,15640.85,2025-07-10,79267.63
1006,163,18433.78,2025-10-17,60833.85
1007,163,15344.26,2026-09-12,45489.59
1008,163,4522.0,2029-07-03,40967.59
1009,163,9378.67,2030-06-13,31588.92
1010,164,28180.19,2021-03-31,309467.46
1011,164,44615.71,2021-06-18,264851.75
1012,164,45273.25,2021-09-30,219578.5
1013,164,27255.11,2022-05-26,192323.39
1014,164,12144.68,2022-06-04,180178.71
1015,165,69427.24,2025-06-30,266104.02
1016,165,69793.5,2026-12-26,196310.52
1017,165,48611.43,2027-08-09,147699.09
1018,165,25750.02,2028-05-09,121949.07
1019,165,35999.89,2029-01-08,85949.18
1020,166,15253.03,2023-12-29,151924.73
1021,166,41991.05,2024-01-10,109933.68
1022,166,31304.96,2024-06-17,78628.72
1023,166,21010.13,2024-10-20,57618.59
1024,166,13128.91,2025-02-17,44489.68
1025,166,8438.26,2025-03-05,36051.42
1026,166,2595.0,2025-03-23,33456.42
1027,166,5336.5,2025-11-14,28119.92
1028,167,37166.91,2023-05-17,148659.96
1029,167,13664.89,2024-04-13,134995.07
1030,167,25670.7,2025-03-21,109324.37
1031,167,14144.72,2025-06-04,95179.65
1032,167,13099.74,2025-06-28,82079.91
1033,167,19728.17,2025-10-16,62351.74
1034,167,4020.76,2026-04-14,58330.98
1035,167,3896.64,2026-05-03,54434.34
1036,168,52921.59,2023-11-06,311167.13
1037,168,46775.95,2026-06-04,264391.18
1038,168,78908.47,2026-06-26,185482.71
1039,168,19988.63,2027-02-13,165494.08
1040,169,84108.59,2023-01-03,225473.29
1041,169,41673.86,2023-03-22,183799.43
1042,169,26777.88,2024-05-22,157021.55
1043,169,46536.84,2025-02-16,110484.71
1044,169,31412.42,2026-11-03,79072.29
1045,169,13784.38,2028-04-27,65287.91
1046,169,18750.31,2029-04-27,46537.6
1047,169,10348.03,2030-04-05,36189.57
1048,170,9887.84,2022-05-11,87138.03
1049,170,7968.81,2023-04-23,79169.22
1050,170,17308.5,2024-07-10,61860.72
1051,170,10698.3,2024-12-22,51162.42
1052,170,10292.5,2025-02-11,40869.92
1053,170,4530.2,2026-01-24,36339.72
1054,171,13639.29,2022-06-11,73809.34
1055,171,4274.3,2022-10-26,69535.04
1056,171,4120.04,2023-08-06,65415.0
1057,171,7977.73,2024-03-18,57437.27
1058,171,14966.15,2024-09-27,42471.12
1059,171,3504.6,2025-03-05,38966.52
1060,171,9204.67,2025-05-20,29761.85
1061,171,8013.14,2025-11-03,21748.71
1062,171,4504.53,2026-04-05,17244.18
1063,171,4268.55,2026-06-19,12975.63
1064,172,98268.11,2022-02-15,380271.46
1065,172,72278.14,2022-03-03,307993.32
1066,172,50680.8,2022-11-03,257312.52
1067,172,25353.9,2022-11-12,231958.62
1068,172,61584.07,2023-08-17,170374.55
1069,172,13702.81,2024-02-23,156671.74
1070,172,17591.84,2024-06-17,139079.9
1071,172,40504.46,2024-07-18,98575.44
1072,172,7018.1,2024-11-12,91557.34
1073,173,38058.49,2023-02-05,139154.51
1074,173,40109.77,2023-05-19,99044.74
1075,173,20320.66,2024-02-08,78724.08
1076,173,15897.33,2024-12-22,62826.75
1077,173,10886.52,2026-07-04,51940.23
1078,173,5940.22,2026-10-12,46000.01
1079,173,7855.74,2028-07-18,38144.27
1080,173,4752.42,2028-08-09,33391.85
1081,173,6710.83,2028-08-10,26681.02
1082,173,6512.78,2030-04-23,20168.24
1083,174,86704.33,2022-05-26,385557.5
1084,174,114443.17,2022-10-21,271114.33
1085,174,52009.83,2023-07-30,219104.5
1086,174,55924.57,2023-08-07,163179.93
1087,174,19641.79,2023-11-14,143538.14
1088,174,20184.56,2024-01-05,123353.58
1089,175,34203.68,2024-11-26,260864.54
1090,175,56304.0,2025-01-10,204560.54
1091,175,32803.59,2025-01-14,171756.95
1092,175,11254.74,2025-01-30,160502.21
1093,175,12852.32,2025-02-02,147649.89
1094,175,16009.54,2025-05-24,131640.35
1095,175,18902.96,2025-06-26,112737.39
1096,175,23382.47,2025-07-05,89354.92
1097,175,19361.65,2025-09-29,69993.27
1098,175,14905.55,2025-10-07,55087.72
1099,176,8621.43,2026-11-17,111568.34
1100,176,13266.53,2027-02-03,98301.81
1101,176,26410.52,2027-03-20,71891.29
1102,176,10415.41,2028-12-25,61475.88
1103,177,24856.1,2024-09-14,67046.16
1104,177,19857.85,2025-07-23,47188.31
1105,177,8915.42,2027-03-08,38272.89
1106,177,7226.54,2028-08-10,31046.35
1107,177,7024.24,2033-02-03,24022.11
1108,177,4486.83,2033-11-19,19535.28
1109,177,4081.14,2033-12-15,15454.14
1110,178,21407.84,2023-04-20,125809.18
1111,178,22879.05,2024-05-28,102930.13
1112,178,6287.31,2025-01-10,96642.82
1113,178,13034.4,2025-03-22,83608.42
1114,178,7512.48,2025-07-16,76095.94
1115,178,6160.47,2025-08-04,69935.47
1116,178,18883.71,2026-06-27,51051.76
1117,178,9297.07,2027-03-05,41754.69
1118,179,19348.88,2024-09-28,104474.22
1119,179,5366.89,2025-08-30,99107.33
1120,179,18489.12,2025-12-25,80618.21
1121,179,13221.51,2026-01-28,67396.7
1122,179,12603.37,2026-12-27,54793.33
1123,179,5194.01,2028-07-22,49599.32
1124,180,64490.32,2021-04-13,432724.31
1125,180,77759.34,2024-06-23,354964.97
1126,180,68530.58,2026-09-29,286434.39
1127,180,73508.15,2028-02-08,212926.24
1128,181,27993.37,2024-12-06,165301.96
1129,181,15741.54,2025-03-05,149560.42
1130,181,43428.67,2025-04-20,106131.75
1131,181,25262.39,2025-09-01,80869.36
1132,181,14550.47,2026-12-18,66318.89
1133,182,25021.77,2022-03-10,308120.93
1134,182,49449.81,2024-10-12,258671.12
1135,182,46012.14,2025-11-18,212658.98
1136,182,16415.4,2026-04-29,196243.58
1137,182,41591.86,2027-02-17,154651.72
1138,182,12112.2,2027-03-08,142539.52
1139,182,8101.8,2028-05-25,134437.72
1140,182,25425.58,2028-10-16,109012.14
1141,182,31604.04,2028-10-25,77408.1
1142,182,6743.95,2029-02-18,70664.15
1143,183,39983.56,2024-09-06,410127.4
1144,183,53118.15,2025-01-25,357009.25
1145,183,101241.94,2026-08-15,255767.31
1146,183,21691.23,2027-11-11,234076.08
1147,183,63857.62,2027-11-30,170218.46
1148,184,58981.24,2022-02-15,283099.74
1149,184,61864.38,2022-03-28,221235.36
1150,184,62563.31,2023-03-11,158672.05
1151,185,69908.44,2024-04-29,229347.73
1152,185,47509.8,2025-05-03,181837.93
1153,185,42175.51,2025-10-25,139662.42
1154,185,23777.7,2028-09-10,115884.72
1155,185,15138.14,2029-11-29,100746.58
1156,185,24960.98,2031-02-21,75785.6
1157,185,15603.95,2031-05-27,60181.65
1158,186,50575.76,2027-07-12,345943.52
1159,186,100701.03,2028-09-23,245242.49
1160,186,25652.89,2031-01-26,219589.6
1161,186,41141.71,2031-05-03,178447.89
1162,186,14184.58,2033-12-05,164263.31
1163,187,15351.76,2026-05-21,282729.85
1164,187,48995.78,2026-08-06,233734.07
1165,187,18703.07,2026-09-26,215031.0
1166,187,37897.21,2027-02-23,177133.79
1167,187,46213.96,2027-05-14,130919.83
1168,187,28131.75,2028-01-28,102788.08
1169,187,26498.8,2028-06-25,76289.28
1170,187,14612.47,2028-09-04,61676.81
1171,187,11579.07,2028-10-23,50097.74
1172,188,27440.56,2024-06-29,78587.75
1173,188,19269.24,2024-08-09,59318.51
1174,188,6767.79,2024-08-25,52550.72
1175,188,4424.31,2024-10-04,48126.41
1176,188,9796.34,2025-04-29,38330.07
1177,189,37006.35,2027-08-09,156656.58
1178,189,10295.73,2027-09-22,146360.85
1179,189,36074.89,2028-04-28,110285.96
1180,189,16018.27,2031-05-12,94267.69
1181,190,86539.02,2024-01-28,213695.18
1182,190,38954.31,2024-02-10,174740.87
1183,190,35935.62,2024-04-25,138805.25
1184,190,37344.71,2024-05-10,101460.54
1185,190,12721.08,2024-07-22,88739.46
1186,191,19413.56,2023-05-10,178099.4
1187,191,47821.81,2024-05-25,130277.59
1188,191,33885.75,2024-07-28,96391.84
1189,191,8823.97,2024-11-07,87567.87
1190,191,23282.58,2025-06-27,64285.29
1191,191,7974.25,2026-04-10,56311.04
1192,191,8069.32,2026-11-17,48241.72
1193,191,11711.49,2026-12-27,36530.23
1194,191,3524.42,2027-05-04,33005.81
1195,191,8482.96,2029-10-05,24522.85
1196,192,40906.86,2024-07-12,312597.34
1197,192,34868.54,2026-12-02,277728.8
1198,192,53294.12,2027-03-14,224434.68
1199,193,100337.51,2023-11-11,273738.24
1200,193,59757.87,2024-02-05,213980.37
1201,193,43845.48,2025-05-24,170134.89
1202,193,28303.6,2025-08-25,141831.29
1203,193,24669.41,2025-11-23,117161.88
1204,193,29726.09,2026-03-02,87435.79
1205,193,25489.16,2026-03-19,61946.63
1206,194,22582.19,2023-03-21,141008.95
1207,194,13708.0,2023-05-08,127300.95
1208,194,30979.17,2023-05-30,96321.78
1209,194,17447.07,2023-10-15,78874.71
1210,194,15529.22,2024-04-04,63345.49
1211,194,10656.4,2024-04-25,52689.09
1212,194,11717.68,2024-07-28,40971.41
1213,194,10054.52,2024-11-07,30916.89
1214,194,7713.28,2024-11-08,23203.61
1215,194,2927.01,2024-12-01,20276.6
1216,195,56569.39,2025-02-08,361001.35
1217,195,43909.36,2025-10-08,317091.99
1218,195,27761.21,2026-03-30,289330.78
1219,195,27501.31,2026-05-10,261829.47
1220,195,20711.23,2026-06-15,241118.24
1221,196,25005.43,2026-04-28,77689.92
1222,196,19956.2,2028-08-11,57733.72
1223,196,13777.94,2030-02-08,43955.78
1224,197,18558.14,2024-10-01,113453.31
1225,197,12497.12,2025-09-25,100956.19
1226,197,22608.79,2026-02-05,78347.4
1227,197,12447.1,2026-06-20,65900.3
1228,197,4887.15,2026-10-22,61013.15
1229,197,17028.29,2027-08-05,43984.86
1230,198,41895.68,2023-11-29,377056.74
1231,198,28685.49,2025-01-17,348371.25
1232,198,35875.22,2025-09-01,312496.03
1233,198,25360.67,2026-09-03,287135.36
1234,198,83432.24,2026-11-03,203703.12
1235,198,52731.73,2027-02-10,150971.39
1236,198,12059.83,2027-06-07,138911.56
1237,198,27745.55,2029-01-26,111166.01
1238,198,27869.88,2029-03-29,83296.13
1239,198,13287.29,2030-02-16,70008.84
1240,199,72268.4,2021-11-30,289104.12
1241,199,69812.85,2022-02-03,219291.27
1242,199,55300.16,2022-06-18,163991.11
1243,199,47653.1,2022-08-12,116338.01
1244,199,6390.47,2023-03-28,109947.54
1245,200,13568.88,2025-12-24,55703.12
1246,200,5607.19,2026-09-07,50095.93
1247,200,11787.42,2027-03-16,38308.51
1248,200,8819.45,2027-04-11,29489.06
1249,200,5284.49,2027-05-03,24204.57
1250,201,46573.32,2023-03-20,248963.74
1251,201,26584.77,2024-10-09,222378.97
1252,201,19545.15,2026-10-27,202833.82
1253,202,15460.66,2023-01-19,256789.63
1254,202,34020.95,2023-01-31,222768.68
1255,202,62455.16,2023-02-17,160313.52
1256,202,36288.74,2023-04-09,124024.78
1257,202,15908.42,2023-05-02,108116.36
1258,203,67600.18,2023-07-24,222413.04
1259,203,43205.77,2024-12-23,179207.27
1260,203,45206.41,2026-01-11,134000.86
1261,203,22163.58,2027-02-25,111837.28
1262,203,30054.64,2027-03-15,81782.64
1263,203,13627.51,2027-05-31,68155.13
1264,203,16436.4,2027-08-05,51718.73
1265,203,5218.81,2029-03-09,46499.92
1266,204,4094.76,2024-12-05,66682.08
1267,204,11879.95,2026-06-26,54802.13
1268,204,6150.87,2027-01-27,48651.26
1269,204,7076.25,2028-04-23,41575.01
1270,204,5653.75,2028-07-12,35921.26
1271,204,3377.17,2028-08-19,32544.09
1272,204,2576.78,2029-06-03,29967.31
1273,204,3682.08,2029-06-23,26285.23
1274,205,13436.35,2024-06-10,108049.83
1275,205,22386.34,2025-08-10,85663.49
1276,205,7734.95,2026-01-10,77928.54
1277,205,10782.42,2026-03-16,67146.12
1278,205,12497.19,2026-03-28,54648.93
1279,205,11449.49,2026-03-30,43199.44
1280,205,10883.84,2026-04-10,32315.6
1281,206,18320.65,2021-04-06,98725.53
1282,206,5547.6,2023-12-18,93177.93
1283,206,17375.18,2024-03-16,75802.75
1284,206,17986.36,2025-05-23,57816.39
1285,206,12427.74,2026-04-23,45388.65
1286,206,10079.24,2026-07-04,35309.41
1287,207,33449.35,2022-11-28,79093.81
1288,207,11423.41,2023-07-07,67670.4
1289,207,11793.16,2023-08-15,55877.24
1290,207,5166.96,2025-10-14,50710.28
1291,207,10861.22,2026-02-21,39849.06
1292,207,9880.22,2026-04-30,29968.84
1293,207,7974.57,2026-12-02,21994.27
1294,207,4844.88,2027-01-11,17149.39
1295,208,23128.92,2023-01-27,398022.27
1296,208,108354.8,2023-03-22,289667.47
1297,208,24275.76,2023-07-13,265391.71
1298,208,65244.09,2023-08-25,200147.62
1299,208,56958.55,2023-09-09,143189.07
1300,208,42217.22,2023-12-31,100971.85
1301,208,16983.26,2024-01-01,83988.59
1302,208,24853.31,2024-04-09,59135.28
1303,208,9421.45,2024-08-07,49713.83
1304,209,128587.05,2026-09-17,338508.77
1305,209,18646.73,2026-12-11,319862.04
1306,209,55130.46,2028-03-14,264731.58
1307,210,4880.61,2023-03-02,81667.21
1308,210,18243.92,2024-01-04,63423.29
1309,210,12052.46,2024-04-14,51370.83
1310,210,8630.75,2024-06-16,42740.08
1311,211,2145.54,2025-07-08,20037.09
1312,211,2678.6,2026-02-09,17358.49
1313,211,1206.02,2027-02-04,16152.47
1314,211,3373.14,2030-06-29,12779.33
1315,211,2571.4,2033-07-22,10207.93
1316,212,11111.96,2023-07-21,68289.98
1317,212,15417.62,2023-08-04,52872.36
1318,212,4697.85,2023-12-08,48174.51
1319,212,7697.82,2024-02-27,40476.69
1320,213,59612.16,2022-08-21,285537.56
1321,213,36459.23,2022-09-02,249078.33
1322,213,71391.84,2022-09-23,177686.49
1323,213,26556.98,2022-12-07,151129.51
1324,213,22286.47,2023-02-13,128843.04
1325,213,21626.73,2023-03-02,107216.31
1326,213,14415.17,2023-03-23,92801.14
1327,213,21525.5,2023-05-28,71275.64
1328,213,19396.39,2023-06-05,51879.25
1329,214,39516.19,2024-01-18,220239.56
1330,214,32260.25,2026-10-01,187979.31
1331,214,39045.31,2028-02-21,148934.0
1332,215,61080.69,2021-06-23,334107.89
1333,215,84107.79,2023-02-16,250000.1
1334,215,24380.15,2023-07-14,225619.95
1335,215,15118.69,2025-09-04,210501.26
1336,215,29147.91,2026-05-24,181353.35
1337,215,22656.55,2028-12-10,158696.8
1338,216,23260.26,2020-11-21,120677.06
1339,216,23714.3,2021-04-21,96962.76
1340,216,23428.29,2021-11-09,73534.47
1341,216,4918.39,2022-03-10,68616.08
1342,216,17021.16,2022-12-18,51594.92
1343,216,12422.01,2023-02-13,39172.91
1344,216,10369.66,2023-05-20,28803.25
1345,216,1498.52,2025-02-11,27304.73
1346,217,8321.32,2022-05-02,100962.0
1347,217,23848.87,2022-11-08,77113.13
1348,217,11786.07,2022-12-13,65327.06
1349,217,17112.49,2023-01-03,48214.57
1350,217,9070.44,2023-02-09,39144.13
1351,218,35486.6,2025-08-26,128448.9
1352,218,21213.13,2025-09-02,107235.77
1353,218,21030.87,2025-11-19,86204.9
1354,218,24652.54,2026-02-04,61552.36
1355,218,13797.54,2026-09-07,47754.82
1356,218,13842.62,2027-03-02,33912.2
1357,218,2550.46,2028-02-22,31361.74
1358,218,6326.52,2028-04-16,25035.22
1359,219,27035.47,2024-05-08,366268.37
1360,219,52810.97,2024-08-27,313457.4
1361,219,84052.49,2025-11-30,229404.91
1362,219,66785.86,2028-01-09,162619.05
1363,219,39953.98,2029-03-05,122665.07
1364,219,22248.13,2029-11-06,100416.94
1365,220,56441.16,2024-02-15,439883.33
1366,220,129561.83,2025-09-24,310321.5
1367,220,82402.41,2027-03-27,227919.09
1368,220,51438.04,2027-07-14,176481.05
1369,220,41226.41,2027-09-05,135254.64
1370,221,14656.96,2023-09-05,69511.41
1371,221,15539.96,2024-08-04,53971.45
1372,221,12339.46,2025-03-10,41631.99
1373,221,8596.85,2025-05-02,33035.14
1374,222,5605.79,2027-04-18,41846.44
1375,222,11039.93,2028-04-19,30806.51
1376,222,3395.33,2028-10-23,27411.18
1377,223,67076.97,2026-05-23,422775.33
1378,223,48773.61,2026-10-02,374001.72
1379,223,102895.25,2027-04-13,271106.47
1380,223,69612.31,2027-05-28,201494.16
1381,223,32291.05,2028-01-24,169203.11
1382,223,11391.06,2030-05-30,157812.05
1383,223,38325.42,2032-05-25,119486.63
1384,224,13397.24,2024-08-06,253034.75
1385,224,50237.01,2024-08-19,202797.74
1386,224,20375.1,2024-08-21,182422.64
1387,224,12450.73,2024-08-28,169971.91
1388,224,38442.0,2024-10-03,131529.91
1389,224,9566.85,2024-12-02,121963.06
1390,224,26185.97,2025-01-03,95777.09
1391,224,5520.83,2025-01-10,90256.26
1392,224,10717.42,2025-04-14,79538.84
1393,224,10743.05,2025-06-25,68795.79
1394,225,90124.76,2024-08-25,275925.92
1395,225,18453.46,2024-09-08,257472.46
1396,225,20159.86,2024-11-19,237312.6
1397,225,38686.47,2024-12-05,198626.13
1398,226,41342.06,2024-12-25,230310.42
1399,226,39981.47,2026-10-28,190328.95
1400,226,17280.44,2029-04-28,173048.51
1401,227,33140.95,2026-04-18,191104.74
1402,227,37934.03,2028-12-04,153170.71
1403,227,40203.17,2029-04-19,112967.54
1404,227,19391.36,2029-08-23,93576.18
1405,227,23592.6,2030-02-17,69983.58
1406,227,19259.0,2031-03-18,50724.58
1407,228,14691.73,2024-05-25,131393.03
1408,228,10111.65,2024-06-08,121281.38
1409,228,23380.7,2024-12-08,97900.68
1410,228,13589.65,2025-04-20,84311.03
1411,228,23634.29,2026-02-07,60676.74
1412,228,8408.12,2026-05-25,52268.62
1413,228,14570.72,2026-08-08,37697.9
1414,228,9476.58,2026-09-10,28221.32
1415,228,7017.79,2026-09-30,21203.53
1416,229,59381.63,2022-04-21,403882.68
1417,229,34704.6,2022-12-17,369178.08
1418,229,27526.2,2023-05-26,341651.88
1419,229,37010.14,2024-02-16,304641.74
1420,229,63591.26,2024-09-18,241050.48
1421,229,56336.48,2026-03-16,184714.0
1422,229,16449.73,2026-03-31,168264.27
1423,229,12638.56,2026-05-10,155625.71
1424,229,23527.6,2027-07-27,132098.11
1425,229,34351.91,2027-12-28,97746.2
1426,230,3328.52,2022-09-04,20086.2
1427,230,3720.1,2022-10-15,16366.1
1428,230,2006.05,2023-01-26,14360.05
1429,230,1339.31,2023-06-12,13020.74
1430,230,2001.02,2023-07-15,11019.72
1431,230,2383.03,2023-08-16,8636.69
1432,231,107219.67,2022-08-08,256635.1
1433,231,69276.75,2024-08-11,187358.35
1434,231,43138.61,2024-11-27,144219.74
1435,231,19981.72,2025-02-02,124238.02
1436,231,21804.06,2025-07-03,102433.96
1437,231,18797.69,2025-12-08,83636.27
1438,231,6454.0,2027-05-13,77182.27
1439,231,4489.17,2027-08-25,72693.1
1440,231,12543.06,2028-01-12,60150.04
1441,231,17850.37,2028-02-11,42299.67
1442,232,97668.51,2027-05-10,344468.99
1443,232,93721.36,2029-02-15,250747.63
1444,232,13652.23,2031-04-05,237095.4
1445,232,55828.3,2031-05-06,181267.1
1446,232,12396.48,2031-06-01,168870.62
1447,232,12095.93,2031-11-18,156774.69
1448,233,35795.86,2024-02-17,93174.25
1449,233,15059.85,2024-03-03,78114.4
1450,233,20798.64,2024-11-24,57315.76
1451,233,15556.05,2025-01-12,41759.71
1452,234,34393.34,2023-04-08,458357.38
1453,234,134397.16,2023-08-28,323960.22
1454,234,64060.6,2023-09-17,259899.62
1455,234,27520.08,2024-08-27,232379.54
1456,234,19020.22,2025-01-23,213359.32
1457,234,17230.35,2025-05-23,196128.97
1458,234,41577.03,2025-05-23,154551.94
1459,234,11278.99,2025-07-01,143272.95
1460,234,17275.68,2025-12-20,125997.27
1461,234,7664.38,2026-01-01,118332.89
1462,235,968.61,2021-06-04,3582.82
1463,235,496.61,2022-04-18,3086.21
1464,235,339.38,2023-12-08,2746.83
1465,235,782.66,2024-06-03,1964.17
1466,235,149.43,2025-04-20,1814.74
1467,235,325.79,2026-01-15,1488.95
1468,235,435.96,2026-08-11,1052.99
1469,235,144.81,2026-12-21,908.18
1470,236,36790.85,2023-05-28,406413.66
1471,236,77118.49,2024-08-04,329295.17
1472,236,68209.79,2025-06-10,261085.38
1473,236,29747.86,2027-03-10,231337.52
1474,236,22164.96,2029-05-27,209172.56
1475,236,32076.87,2030-01-08,177095.69
1476,236,33551.15,2030-04-21,143544.54
1477,236,28486.93,2030-06-28,115057.61
1478,236,27594.78,2030-11-30,87462.83
1479,237,105849.27,2024-08-01,334956.59
1480,237,63651.01,2025-05-21,271305.58
1481,237,20176.38,2026-04-23,251129.2
1482,237,69892.38,2028-03-17,181236.82
1483,237,36356.84,2028-12-22,144879.98
1484,237,24045.34,2030-10-13,120834.64
1485,237,19596.28,2032-11-03,101238.36
1486,237,21319.46,2033-12-02,79918.9
1487,238,54379.46,2022-07-02,297002.78
1488,238,54983.33,2022-10-09,242019.45
1489,238,32399.69,2022-11-12,209619.76
1490,238,62604.22,2022-12-18,147015.54
1491,238,32610.23,2022-12-19,114405.31
1492,239,46362.95,2021-11-12,336056.13
1493,239,28420.33,2021-12-28,307635.8
1494,239,33438.67,2022-03-14,274197.13
1495,239,56240.16,2022-05-06,217956.97
1496,239,25906.01,2023-01-14,192050.96
1497,239,15579.41,2027-03-30,176471.55
1498,240,75484.39,2021-11-03,367451.68
1499,240,38497.5,2022-11-03,328954.18
1500,240,47493.5,2025-01-26,281460.68
1501,240,71617.49,2025-04-18,209843.19
1502,240,49380.06,2025-09-04,160463.13
1503,240,23812.92,2025-12-08,136650.21
1504,240,28399.26,2026-03-23,108250.95
1505,241,36818.25,2022-08-06,233337.32
1506,241,56349.75,2022-09-02,176987.57
1507,241,35963.81,2025-05-09,141023.76
1508,242,73534.5,2025-09-25,383508.36
1509,242,36856.02,2026-09-12,346652.34
1510,242,103271.47,2027-04-11,243380.87
1511,243,122266.88,2027-06-06,308028.83
1512,243,16947.62,2027-08-16,291081.21
1513,243,73282.14,2030-10-06,217799.07
1514,243,26502.63,2031-03-24,191296.44
1515,243,12302.05,2033-01-11,178994.39
1516,243,47970.38,2033-11-25,131024.01
1517,244,34444.32,2022-03-02,234161.89
1518,244,38012.85,2022-05-25,196149.04
1519,244,35834.81,2022-08-22,160314.23
1520,244,8827.23,2022-10-10,151487.0
1521,244,17448.36,2023-06-17,134038.64
1522,244,8664.78,2023-07-25,125373.86
1523,244,30665.09,2023-11-18,94708.77
1524,244,15059.28,2023-12-28,79649.49
1525,244,10220.46,2024-09-03,69429.03
1526,244,6026.05,2024-09-17,63402.98
1527,245,37848.42,2024-03-02,133365.89
1528,245,25205.24,2024-09-27,108160.65
1529,245,12053.11,2024-12-26,96107.54
1530,245,23267.58,2029-04-02,72839.96
1531,245,21602.06,2031-08-28,51237.9
1532,245,5879.74,2031-11-01,45358.16
1533,245,6630.25,2031-11-08,38727.91
1534,245,4319.14,2032-05-23,34408.77
1535,246,1909.85,2023-10-20,16994.03
1536,246,1729.53,2026-01-04,15264.5
1537,246,2454.32,2026-02-07,12810.18
1538,246,2717.62,2026-12-16,10092.56
1539,246,1066.98,2027-02-07,9025.58
1540,246,1934.31,2027-02-15,7091.27
1541,246,1870.52,2028-01-16,5220.75
1542,247,29171.72,2025-04-28,354772.2
1543,247,20099.84,2025-04-29,334672.36
1544,247,58505.97,2025-05-04,276166.39
1545,247,23533.29,2026-07-20,252633.1
1546,247,18185.93,2026-10-01,234447.17
1547,247,33119.15,2029-01-03,201328.02
1548,247,56411.99,2030-03-20,144916.03
1549,248,45931.7,2024-06-06,385759.64
1550,248,51104.81,2024-10-19,334654.83
1551,248,81449.52,2024-10-21,253205.31
1552,248,51218.6,2024-10-31,201986.71
1553,248,52412.56,2024-11-05,149574.15
1554,248,34843.0,2024-11-12,114731.15
1555,248,10666.85,2024-12-25,104064.3
1556,248,26361.98,2024-12-26,77702.32
1557,248,5235.38,2025-09-20,72466.94
1558,248,16954.24,2026-03-29,55512.7
1559,249,131908.3,2022-01-07,353609.51
1560,249,79489.99,2022-04-26,274119.52
1561,249,50945.54,2022-07-30,223173.98
1562,249,56343.44,2022-10-25,166830.54
1563,249,17743.46,2023-05-03,149087.08
1564,249,33127.39,2023-07-28,115959.69
1565,249,16302.27,2023-12-15,99657.42
1566,249,5764.77,2024-01-20,93892.65
1567,249,16579.91,2024-02-18,77312.74
1568,249,6819.18,2024-04-03,70493.56
1569,250,33389.17,2024-01-26,217087.44
1570,250,41968.12,2025-11-19,175119.32
1571,250,45480.4,2026-09-03,129638.92
1572,250,30250.63,2028-08-14,99388.29
1573,250,11373.67,2029-04-28,88014.62
1574,250,14241.29,2030-03-09,73773.33
1575,251,4533.18,2023-06-26,21288.42
1576,251,1727.99,2023-10-18,19560.43
1577,251,1253.33,2025-05-19,18307.1
1578,251,2704.32,2025-08-01,15602.78
1579,251,4134.15,2025-10-04,11468.63
1580,251,2913.13,2026-05-21,8555.5
1581,251,1857.57,2027-03-08,6697.93
1582,251,1967.41,2027-03-16,4730.52
1583,251,357.62,2027-06-15,4372.9
1584,251,321.22,2028-12-14,4051.68
1585,252,1278.12,2028-03-25,6357.83
1586,252,696.16,2028-05-31,5661.67
1587,252,915.53,2028-07-25,4746.14
1588,252,290.73,2028-09-02,4455.41
1589,252,841.51,2028-09-09,3613.9
1590,252,581.24,2030-02-20,3032.66
1591,252,493.14,2030-09-17,2539.52
1592,253,18227.73,2023-12-23,71145.22
1593,253,16968.68,2024-05-10,54176.54
1594,253,10890.69,2024-06-18,43285.85
1595,253,12810.71,2024-07-31,30475.14
1596,253,8956.43,2024-09-15,21518.71
1597,253,4434.38,2024-10-11,17084.33
1598,253,5119.0,2024-10-24,11965.33
1599,253,1289.62,2024-10-26,10675.71
1600,254,57411.03,2022-07-12,229733.02
1601,254,44737.69,2023-02-07,184995.33
1602,254,11405.52,2023-08-11,173589.81
1603,254,17970.69,2023-12-02,155619.12
1604,254,35562.7,2024-01-24,120056.42
1605,254,28068.74,2024-03-25,91987.68
1606,254,20075.64,2024-05-20,71912.04
1607,254,20514.68,2024-06-20,51397.36
1608,254,8404.83,2024-10-28,42992.53
1609,254,5650.73,2024-10-31,37341.8
1610,255,27447.32,2021-11-23,71700.69
1611,255,7045.28,2021-12-15,64655.41
1612,255,5911.95,2022-03-18,58743.46
1613,255,9613.34,2027-03-09,49130.12
1614,256,54299.94,2024-05-17,222142.55
1615,256,42654.69,2026-08-26,179487.86
1616,256,44056.41,2026-11-25,135431.45
1617,257,57127.12,2021-03-09,177126.44
1618,257,21808.84,2021-11-12,155317.6
1619,257,27839.68,2023-07-06,127477.92
1620,257,25448.75,2023-10-22,102029.17
1621,258,34486.12,2023-06-17,278072.66
1622,258,28265.75,2023-06-21,249806.91
1623,258,25256.97,2023-06-22,224549.94
1624,258,49604.32,2024-01-23,174945.62
1625,258,16774.7,2024-04-19,158170.92
1626,258,25482.36,2024-08-07,132688.56
1627,258,32791.36,2025-03-28,99897.2
1628,258,19805.28,2025-11-01,80091.92
1629,259,14024.62,2025-02-08,125555.36
1630,259,11113.19,2025-06-04,114442.17
1631,259,21437.68,2026-02-25,93004.49
1632,259,10949.86,2027-05-05,82054.63
1633,259,5677.86,2027-09-20,76376.77
1634,259,12525.5,2028-08-02,63851.27
1635,259,12389.53,2029-12-20,51461.74
1636,260,57342.65,2024-08-17,283606.53
1637,260,41294.48,2024-10-23,242312.05
1638,260,23207.86,2025-11-20,219104.19
1639,260,55957.36,2026-04-21,163146.83
1640,260,21750.15,2026-06-03,141396.68
1641,260,27585.79,2027-01-22,113810.89
1642,260,10909.98,2027-11-14,102900.91
1643,260,9206.98,2028-07-29,93693.93
1644,260,17089.96,2028-12-30,76603.97
1645,261,89898.69,2025-01-10,319421.84
1646,261,89176.37,2025-09-09,230245.47
1647,261,64602.68,2025-12-12,165642.79
1648,261,11139.35,2026-01-06,154503.44
1649,261,21844.53,2027-01-08,132658.91
1650,261,25928.5,2027-09-18,106730.41
1651,261,19853.53,2028-03-02,86876.88
1652,261,18213.26,2028-03-13,68663.62
1653,261,9938.57,2028-06-10,58725.05
1654,261,11210.3,2028-08-07,47514.75
1655,262,902.89,2022-12-03,6213.27
1656,262,1220.8,2025-01-12,4992.47
1657,262,357.55,2025-01-13,4634.92
1658,262,367.73,2025-07-25,4267.19
1659,262,810.23,2026-02-18,3456.96
1660,262,494.26,2026-03-23,2962.7
1661,263,121233.39,2022-09-09,292387.8
1662,263,34556.66,2022-12-06,257831.14
1663,263,67229.94,2023-01-28,190601.2
1664,263,15399.77,2023-07-23,175201.43
1665,263,51649.69,2024-03-02,123551.74
1666,263,14690.37,2024-08-20,108861.37
1667,264,28665.32,2024-11-14,188530.59
1668,264,27616.37,2025-04-05,160914.22
1669,264,40484.93,2025-10-25,120429.29
1670,264,29683.97,2025-12-31,90745.32
1671,264,5161.4,2026-01-04,85583.92
1672,264,13923.03,2026-06-10,71660.89
1673,264,16151.82,2026-09-14,55509.07
1674,264,15881.1,2027-04-06,39627.97
1675,264,2399.72,2027-04-15,37228.25
1676,264,5079.33,2027-04-26,32148.92
1677,265,20675.82,2020-12-23,182315.82
1678,265,40569.09,2021-03-29,141746.73
1679,265,34091.13,2021-09-11,107655.6
1680,265,20830.63,2022-07-08,86824.97
1681,265,5339.97,2022-08-28,81485.0
1682,265,18247.03,2022-12-18,63237.97
1683,265,6953.11,2024-01-12,56284.86
1684,265,5354.47,2024-08-17,50930.39
1685,266,44525.9,2021-10-31,413845.86
1686,266,56526.45,2025-08-26,357319.41
1687,266,44825.93,2026-11-23,312493.48
1688,266,24413.66,2028-02-24,288079.82
1689,267,103292.91,2021-02-20,298784.41
1690,267,47455.35,2022-01-08,251329.06
1691,267,73769.83,2023-01-08,177559.23
1692,267,51409.67,2023-08-29,126149.56
1693,267,29461.29,2023-09-19,96688.27
1694,267,6697.23,2025-11-11,89991.04
1695,268,11729.65,2024-01-28,108871.25
1696,268,19200.62,2024-05-04,89670.63
1697,268,14615.39,2025-01-24,75055.24
1698,268,15120.13,2025-04-26,59935.11
1699,268,13043.8,2025-11-18,46891.31
1700,268,5252.3,2026-03-11,41639.01
1701,268,6143.18,2026-07-21,35495.83
1702,268,10595.56,2026-11-18,24900.27
1703,269,47242.27,2022-08-25,427911.33
1704,269,121605.78,2023-08-28,306305.55
1705,269,75489.0,2025-04-24,230816.55
1706,269,68906.75,2025-05-08,161909.8
1707,269,20256.85,2025-08-10,141652.95
1708,269,34790.18,2026-03-16,106862.77
1709,270,74812.7,2023-06-12,412068.27
1710,270,107839.12,2023-12-11,304229.15
1711,270,29947.7,2025-04-18,274281.45
1712,270,55710.55,2027-09-17,218570.9
1713,270,58796.88,2027-11-21,159774.02
1714,270,26460.4,2028-02-03,133313.62
1715,270,14356.23,2028-07-17,118957.39
1716,271,88543.91,2022-10-09,210072.59
1717,271,42308.89,2023-01-19,167763.7
1718,271,26866.99,2023-10-22,140896.71
1719,271,41073.57,2025-01-15,99823.14
1720,271,16323.39,2025-11-06,83499.75
1721,271,5792.24,2027-07-30,77707.51
1722,271,12653.6,2028-07-16,65053.91
1723,272,17187.46,2026-10-05,269600.39
1724,272,29279.67,2027-05-08,240320.72
1725,272,43984.55,2030-04-15,196336.17
1726,273,5910.62,2026-08-02,90882.79
1727,273,27058.28,2027-11-30,63824.51
1728,273,18067.98,2028-10-07,45756.53
1729,273,13718.01,2029-07-16,32038.52
1730,273,9326.38,2029-07-31,22712.14
1731,273,4925.27,2029-12-15,17786.87
1732,273,2169.8,2031-11-03,15617.07
1733,273,3238.99,2032-02-15,12378.08
1734,274,33982.22,2024-04-29,150542.07
1735,274,43283.1,2027-07-09,107258.97
1736,274,22472.33,2031-05-23,84786.64
1737,274,6473.67,2031-06-29,78312.97
1738,274,4059.53,2032-09-28,74253.44
1739,274,6854.47,2032-12-27,67398.97
1740,275,33020.99,2024-01-02,232854.47
1741,275,43699.48,2024-03-20,189154.99
1742,275,42144.31,2024-04-20,147010.68
1743,275,20653.88,2024-09-18,126356.8
1744,275,10419.09,2024-11-11,115937.71
1745,275,16547.47,2025-01-06,99390.24
1746,275,19918.03,2025-04-10,79472.21
1747,275,8302.13,2025-09-11,71170.08
1748,275,8334.4,2025-09-18,62835.68
1749,276,10404.37,2021-07-26,75402.31
1750,276,6746.08,2021-09-04,68656.23
1751,276,3737.44,2021-09-13,64918.79
1752,276,17362.76,2021-09-21,47556.03
1753,276,9654.09,2021-10-03,37901.94
1754,277,109036.84,2024-07-15,349597.3
1755,277,102737.83,2024-11-02,246859.47
1756,277,32804.64,2024-12-08,214054.83
1757,277,58940.78,2024-12-22,155114.05
1758,277,18416.47,2025-01-11,136697.58
1759,278,17033.28,2022-02-20,45498.12
1760,278,6301.21,2022-04-15,39196.91
1761,278,7757.81,2022-04-17,31439.1
1762,278,2774.82,2022-05-12,28664.28
1763,278,5348.38,2022-06-08,23315.9
1764,278,2551.45,2022-09-29,20764.45
1765,278,1879.96,2022-11-11,18884.49
1766,278,3988.35,2022-12-25,14896.14
1767,279,61032.81,2028-08-07,158941.28
1768,279,11112.81,2029-06-13,147828.47
1769,279,29554.89,2032-02-05,118273.58
1770,279,28020.93,2032-09-19,90252.65
1771,279,23548.46,2033-01-02,66704.19
1772,280,6075.65,2021-08-08,15277.07
1773,280,3394.9,2023-02-22,11882.17
1774,280,1527.58,2023-05-09,10354.59
1775,280,2955.6,2023-07-29,7398.99
1776,280,555.75,2024-09-15,6843.24
1777,280,661.42,2024-10-08,6181.82
1778,280,1044.47,2025-01-14,5137.35
1779,280,926.81,2025-03-24,4210.54
1780,280,1249.99,2025-06-08,2960.55
1781,280,425.09,2025-07-19,2535.46
1782,281,75901.9,2025-06-09,200261.4
1783,281,20906.43,2026-03-29,179354.97
1784,281,14696.74,2030-04-19,164658.23
1785,281,23790.28,2030-11-10,140867.95
1786,281,19366.8,2031-05-31,121501.15
1787,281,25540.72,2031-08-31,95960.43
1788,281,7163.26,2031-12-06,88797.17
1789,281,10121.44,2032-01-22,78675.73
1790,281,12060.46,2032-02-11,66615.27
1791,281,9645.48,2033-10-06,56969.79
1792,282,13031.0,2023-05-10,46825.49
1793,282,4636.68,2023-10-11,42188.81
1794,282,9932.95,2025-06-13,32255.86
1795,282,3960.92,2025-07-27,28294.94
1796,282,3709.19,2026-04-14,24585.75
1797,283,80426.44,2024-03-18,300606.69
1798,283,36747.37,2024-08-15,263859.32
1799,283,30618.39,2025-01-05,233240.93
1800,283,31089.16,2025-03-31,202151.77
1801,283,48610.07,2026-02-19,153541.7
1802,283,28352.54,2026-11-10,125189.16
1803,283,28608.11,2027-05-16,96581.05
1804,284,32169.95,2021-06-30,281855.14
1805,284,81177.09,2022-02-07,200678.05
1806,284,28432.91,2022-03-19,172245.14
1807,284,47841.05,2022-10-09,124404.09
1808,284,25166.67,2023-12-05,99237.42
1809,284,13364.46,2024-05-10,85872.96
1810,284,7623.32,2024-05-23,78249.64
1811,284,21689.19,2024-06-02,56560.45
1812,284,5354.27,2024-09-09,51206.18
1813,284,11361.26,2024-11-29,39844.92
1814,285,14918.8,2025-02-27,43474.84
1815,285,6914.13,2026-10-19,36560.71
1816,285,5399.36,2027-07-17,31161.35
1817,285,3578.49,2028-12-14,27582.86
1818,285,2337.2,2030-12-25,25245.66
1819,285,1727.32,2031-01-10,23518.34
1820,285,3521.87,2031-01-14,19996.47
1821,285,3728.94,2031-03-29,16267.53
1822,286,32053.79,2025-01-02,271446.95
1823,286,80404.07,2025-01-17,191042.88
1824,286,10899.74,2025-12-08,180143.14
1825,286,26623.6,2026-10-05,153519.54
1826,286,21331.23,2029-02-04,132188.31
1827,286,28816.99,2030-05-18,103371.32
1828,286,18300.7,2031-04-04,85070.62
1829,286,14535.53,2032-02-06,70535.09
1830,287,47814.56,2021-10-15,277448.71
1831,287,53074.33,2022-02-22,224374.38
1832,287,30395.91,2022-04-28,193978.47
1833,287,21184.49,2022-12-29,172793.98
1834,287,12088.72,2023-03-31,160705.26
1835,287,34014.01,2023-05-09,126691.25
1836,287,30581.21,2023-10-16,96110.04
1837,287,22741.28,2025-01-07,73368.76
1838,287,18508.85,2025-01-25,54859.91
1839,287,10326.27,2025-10-21,44533.64
1840,288,20017.49,2025-04-18,93832.28
1841,288,20900.15,2025-09-01,72932.13
1842,288,8905.36,2027-01-19,64026.77
1843,288,7509.59,2028-09-19,56517.18
1844,288,14477.37,2030-02-23,42039.81
1845,288,9131.38,2030-04-09,32908.43
1846,288,7834.73,2030-12-11,25073.7
1847,288,5914.11,2030-12-15,19159.59
1848,289,18130.53,2022-08-26,80639.43
1849,289,18781.77,2025-06-29,61857.66
1850,289,6551.69,2025-07-18,55305.97
1851,289,9605.03,2027-01-06,45700.94
1852,289,11516.23,2027-05-19,34184.71
1853,290,53207.37,2024-03-23,255865.62
1854,290,44119.38,2026-07-21,211746.24
1855,290,34857.88,2027-05-08,176888.36
1856,290,37370.58,2027-12-26,139517.78
1857,290,7709.75,2028-09-03,131808.03
1858,291,22737.08,2022-04-25,164386.56
1859,291,31809.23,2023-04-13,132577.33
1860,291,29679.39,2023-04-17,102897.94
1861,291,16700.81,2024-11-05,86197.13
1862,291,11968.57,2025-07-27,74228.56
1863,291,10912.04,2026-03-21,63316.52
1864,291,7707.04,2026-04-16,55609.48
1865,291,7858.75,2027-06-13,47750.73
1866,291,10241.55,2028-11-24,37509.18
1867,292,5840.23,2024-03-30,81889.09
1868,292,4962.2,2025-09-08,76926.89
1869,292,18497.41,2025-09-21,58429.48
1870,292,3282.78,2025-10-27,55146.7
1871,292,8512.61,2026-03-04,46634.09
1872,292,4143.88,2026-10-20,42490.21
1873,292,2369.99,2027-04-14,40120.22
1874,292,2012.05,2027-07-19,38108.17
1875,292,6536.36,2028-01-24,31571.81
1876,293,69061.16,2024-04-20,245710.87
1877,293,65574.03,2024-10-03,180136.84
1878,293,37807.08,2024-10-04,142329.76
1879,293,29206.12,2025-06-30,113123.64
1880,293,7137.94,2025-12-31,105985.7
1881,293,31162.34,2026-08-19,74823.36
1882,293,13935.58,2028-07-06,60887.78
1883,293,13848.98,2028-08-29,47038.8
1884,294,92281.56,2022-05-19,316861.28
1885,294,17202.31,2022-11-18,299658.97
1886,294,42325.46,2026-03-02,257333.51
1887,294,67559.86,2028-12-26,189773.65
1888,294,50860.2,2029-08-24,138913.45
1889,294,39642.4,2030-07-06,99271.05
1890,294,14444.41,2031-07-29,84826.64
1891,294,23526.79,2031-08-02,61299.85
1892,295,32789.38,2023-06-25,162822.9
1893,295,9305.11,2026-01-21,153517.79
1894,295,18680.23,2026-06-09,134837.56
1895,296,61948.79,2025-08-26,191531.09
1896,296,47422.82,2025-10-13,144108.27
1897,296,10397.12,2025-10-23,133711.15
1898,296,36198.61,2026-05-30,97512.54
1899,296,23625.85,2026-09-15,73886.69
1900,296,6535.19,2027-03-30,67351.5
1901,296,6923.18,2027-09-08,60428.32
1902,296,4173.0,2027-10-04,56255.32
1903,296,6372.44,2027-12-31,49882.88
1904,297,45083.15,2024-11-18,319400.2
1905,297,89354.04,2025-06-18,230046.16
1906,297,53709.65,2026-01-20,176336.51
1907,297,44918.76,2026-10-05,131417.75
1908,297,34251.7,2026-10-17,97166.05
1909,297,22743.66,2026-12-20,74422.39
1910,297,15864.96,2026-12-25,58557.43
1911,298,11472.57,2025-08-26,28541.85
1912,298,1618.66,2026-02-24,26923.19
1913,298,4179.96,2030-01-05,22743.23
1914,299,46791.08,2026-07-13,158747.97
1915,299,32502.38,2026-07-16,126245.59
1916,299,9534.49,2026-12-31,116711.1
1917,299,6110.79,2027-01-03,110600.31
1918,299,5927.4,2027-02-24,104672.91
1919,299,22611.13,2028-06-17,82061.78
1920,299,8162.47,2030-06-01,73899.31
1921,299,20281.65,2030-08-29,53617.66
1922,299,9591.57,2031-07-02,44026.09
1923,300,65852.02,2026-08-11,341596.3
1924,300,18995.42,2030-08-21,322600.88
1925,300,50316.32,2031-11-16,272284.56
1926,300,44225.34,2031-12-07,228059.22
1927,300,20079.24,2032-01-21,207979.98
1928,301,2568.46,2027-07-23,19335.85
1929,301,4267.89,2028-12-26,15067.96
1930,301,3942.17,2028-12-31,11125.79
1931,301,2372.7,2030-09-22,8753.09
1932,301,2133.0,2031-04-19,6620.09
1933,301,1551.78,2033-08-23,5068.31
1934,302,14019.37,2023-11-18,34804.64
1935,302,2844.28,2024-05-27,31960.36
1936,302,7452.49,2024-09-30,24507.87
1937,302,7220.19,2024-12-12,17287.68
1938,302,4300.49,2027-01-30,12987.19
1939,303,48494.2,2022-06-25,359612.36
1940,303,66588.21,2022-09-29,293024.15
1941,303,27481.9,2022-11-05,265542.25
1942,303,32707.91,2022-11-10,232834.34
1943,303,62608.46,2023-02-13,170225.88
1944,303,27013.23,2023-04-12,143212.65
1945,304,61365.68,2021-12-23,416370.99
1946,304,109543.44,2022-03-14,306827.55
1947,304,40536.89,2022-11-04,266290.66
1948,305,9637.15,2022-01-18,65678.08
1949,305,9915.17,2022-10-15,55762.91
1950,305,12282.67,2022-12-14,43480.24
1951,305,11981.63,2024-03-10,31498.61
1952,305,5095.04,2024-08-30,26403.57
1953,305,2793.96,2024-09-02,23609.61
1954,305,4235.39,2025-01-16,19374.22
1955,305,2516.92,2025-01-19,16857.3
1956,306,83250.27,2026-07-19,373468.88
1957,306,52978.74,2026-08-14,320490.14
1958,306,54660.72,2028-01-21,265829.42
1959,306,60451.68,2030-09-17,205377.74
1960,307,20896.54,2024-05-14,350336.92
1961,307,73589.21,2024-09-01,276747.71
1962,307,26446.37,2024-10-09,250301.34
1963,307,68863.0,2024-12-02,181438.34
1964,307,11394.4,2025-09-03,170043.94
1965,307,29368.85,2025-09-15,140675.09
1966,307,21731.7,2025-09-24,118943.39
1967,307,17918.6,2026-01-17,101024.79
1968,308,45902.49,2021-03-28,221243.93
1969,308,61145.74,2021-04-21,160098.19
1970,308,12628.19,2021-06-23,147470.0
1971,308,10748.49,2023-01-21,136721.51
1972,308,34929.1,2025-03-07,101792.41
1973,309,20838.95,2021-06-24,155666.02
1974,309,18437.61,2021-07-18,137228.41
1975,309,7138.38,2021-09-26,130090.03
1976,309,35395.79,2021-11-14,94694.24
1977,309,9610.39,2021-12-29,85083.85
1978,309,24426.7,2022-06-05,60657.15
1979,310,59491.75,2021-09-20,310257.71
1980,310,77937.53,2022-02-02,232320.18
1981,310,24326.62,2022-04-27,207993.56
1982,310,45755.15,2022-08-02,162238.41
1983,310,19524.97,2023-04-27,142713.44
1984,310,41353.86,2023-07-14,101359.58
1985,310,15075.42,2024-01-15,86284.16
1986,310,5106.77,2024-12-24,81177.39
1987,311,3181.21,2024-11-09,18588.82
1988,311,2371.59,2025-03-13,16217.23
1989,311,943.19,2026-04-21,15274.04
1990,311,3810.82,2026-06-26,11463.22
1991,311,1619.35,2030-07-24,9843.87
1992,311,1852.24,2030-08-19,7991.63
1993,311,1833.96,2030-09-13,6157.67
1994,312,16699.56,2023-08-02,76221.55
1995,312,14416.18,2026-05-30,61805.37
1996,312,10895.57,2026-07-05,50909.8
1997,312,7688.74,2026-07-17,43221.06
1998,312,11620.97,2027-01-29,31600.09
1999,312,3376.06,2027-11-24,28224.03
2000,312,4214.18,2027-12-09,24009.85
2001,312,5801.14,2030-03-07,18208.71
2002,313,53471.21,2021-04-15,379980.09
2003,313,47451.49,2022-01-27,332528.6
2004,313,45111.6,2023-09-14,287417.0
2005,313,72628.69,2026-05-03,214788.31
2006,313,21779.62,2026-06-01,193008.69
2007,313,38656.02,2026-06-28,154352.67
2008,313,39042.26,2028-06-21,115310.41
2009,313,16135.16,2029-03-27,99175.25
2010,313,28205.51,2029-09-27,70969.74
2011,314,9783.19,2021-01-15,41390.42
2012,314,12245.25,2024-05-20,29145.17
2013,314,4245.64,2027-01-03,24899.53
2014,314,4514.04,2027-06-24,20385.49
2015,314,3343.97,2028-06-22,17041.52
2016,314,4770.22,2030-03-26,12271.3
2017,315,13650.6,2022-01-02,95223.34
2018,315,24149.08,2022-05-17,71074.26
2019,315,14331.92,2022-11-27,56742.34
2020,315,7560.07,2022-12-12,49182.27
2021,315,13352.09,2023-02-12,35830.18
2022,315,4766.14,2023-05-08,31064.04
2023,315,2835.53,2023-07-11,28228.51
2024,315,5449.18,2023-08-05,22779.33
2025,315,3642.84,2023-10-25,19136.49
2026,315,2072.63,2023-12-05,17063.86
2027,316,83457.64,2021-02-12,278594.28
2028,316,54813.08,2021-03-19,223781.2
2029,316,29116.06,2021-06-03,194665.14
2030,316,47072.68,2021-07-28,147592.46
2031,316,9240.98,2022-09-28,138351.48
2032,317,2006.17,2025-02-26,17040.69
2033,317,4790.41,2025-03-18,12250.28
2034,317,2442.34,2025-04-05,9807.94
2035,317,1572.75,2025-09-25,8235.19
2036,317,1912.14,2025-11-25,6323.05
2037,317,755.1,2026-01-29,5567.95
2038,317,1373.44,2026-06-11,4194.51
2039,317,918.71,2026-06-23,3275.8
2040,318,37630.65,2021-09-01,176012.98
2041,318,20369.06,2022-05-12,155643.92
2042,318,46454.7,2023-09-01,109189.22
2043,318,12205.78,2024-08-07,96983.44
2044,319,41802.43,2022-02-11,370468.96
2045,319,23770.34,2022-03-28,346698.62
2046,319,100956.58,2022-06-24,245742.04
2047,319,13744.67,2022-11-24,231997.37
2048,319,25150.52,2023-07-28,206846.85
2049,319,27730.09,2024-01-21,179116.76
2050,319,48211.79,2024-05-04,130904.97
2051,319,37605.29,2024-06-08,93299.68
2052,319,20625.4,2024-08-26,72674.28
2053,320,68749.56,2021-01-02,274173.27
2054,320,19741.73,2021-02-08,254431.54
2055,320,27360.95,2021-07-26,227070.59
2056,320,27897.8,2021-11-07,199172.79
2057,320,42098.06,2023-04-11,157074.73
2058,320,19852.07,2024-03-06,137222.66
2059,320,33852.1,2024-06-15,103370.56
2060,321,104544.52,2025-01-17,293477.43
2061,321,29503.73,2026-02-14,263973.7
2062,321,48305.2,2026-11-26,215668.5
2063,321,60808.27,2027-08-21,154860.23
2064,321,25176.77,2029-10-01,129683.46
2065,322,60933.38,2020-10-31,303699.95
2066,322,24280.76,2021-01-19,279419.19
2067,322,42309.92,2021-06-22,237109.27
2068,322,24010.82,2021-11-02,213098.45
2069,322,41301.62,2021-11-27,171796.83
2070,322,30797.76,2022-06-20,140999.07
2071,322,23675.9,2022-07-07,117323.17
2072,322,21860.44,2022-08-31,95462.73
2073,322,11997.41,2023-04-04,83465.32
2074,322,12938.41,2023-06-29,70526.91
2075,323,50118.27,2023-01-22,303400.99
2076,323,87184.93,2023-02-19,216216.06
2077,323,27393.64,2023-04-17,188822.42
2078,323,27211.4,2023-05-14,161611.02
2079,323,48043.9,2023-05-31,113567.12
2080,323,22537.99,2023-06-23,91029.13
2081,323,15134.35,2023-07-31,75894.78
2082,323,5835.07,2023-10-01,70059.71
2083,323,18198.98,2023-11-27,51860.73
2084,323,2604.52,2023-12-07,49256.21
2085,324,34767.55,2021-11-29,165295.56
2086,324,8715.13,2022-11-17,156580.43
2087,324,45870.73,2023-05-01,110709.7
2088,324,20669.82,2023-11-04,90039.88
2089,324,24318.87,2025-03-21,65721.01
2090,324,8874.52,2025-08-30,56846.49
2091,324,3879.81,2025-09-15,52966.68
2092,325,50854.93,2025-10-17,122022.62
2093,325,27025.01,2026-08-30,94997.61
2094,325,11222.88,2028-01-02,83774.73
2095,325,8394.13,2028-03-08,75380.6
2096,325,16521.8,2028-10-02,58858.8
2097,325,9671.63,2029-03-29,49187.17
2098,325,4827.73,2029-08-20,44359.44
2099,325,6782.67,2030-01-27,37576.77
2100,325,4384.59,2030-02-11,33192.18
2101,326,99198.3,2024-05-08,353354.37
2102,326,28015.98,2025-12-03,325338.39
2103,326,67981.55,2027-05-04,257356.84
2104,326,43609.2,2028-09-10,213747.64
2105,327,57475.61,2023-06-12,341927.58
2106,327,42967.75,2023-08-01,298959.83
2107,327,30365.39,2023-12-24,268594.44
2108,327,47719.89,2027-03-17,220874.55
2109,327,23763.49,2028-07-27,197111.06
2110,328,107580.64,2023-09-24,254151.02
2111,328,68316.42,2025-06-17,185834.6
2112,328,50809.64,2025-08-11,135024.96
2113,328,16073.35,2027-03-24,118951.61
2114,328,8820.03,2028-10-20,110131.58
2115,328,24660.18,2029-03-01,85471.4
2116,329,31924.22,2022-01-10,239834.2
2117,329,35857.25,2022-06-28,203976.95
2118,329,41208.75,2025-10-05,162768.2
2119,329,36015.9,2025-12-30,126752.3
2120,329,14895.08,2026-07-19,111857.22
2121,329,20521.06,2026-10-21,91336.16
2122,329,14526.88,2028-01-06,76809.28
2123,330,33436.3,2023-01-23,199756.7
2124,330,33671.76,2023-07-24,166084.94
2125,330,40697.07,2024-06-02,125387.87
2126,330,21950.2,2024-08-16,103437.67
2127,330,10267.29,2025-03-10,93170.38
2128,330,14220.17,2028-05-30,78950.21
2129,331,54309.0,2020-10-26,327161.04
2130,331,22963.93,2020-11-17,304197.11
2131,331,86328.1,2021-01-03,217869.01
2132,331,30793.99,2021-01-11,187075.02
2133,331,26814.76,2021-01-15,160260.26
2134,331,37245.11,2021-04-07,123015.15
2135,331,10970.12,2021-05-12,112045.03
2136,331,14748.53,2021-09-02,97296.5
2137,331,15402.37,2021-09-15,81894.13
2138,331,19406.31,2021-10-08,62487.82
2139,332,60614.46,2023-10-05,292293.15
2140,332,68483.56,2024-05-18,223809.59
2141,332,28394.1,2024-09-21,195415.49
2142,332,24470.21,2024-11-06,170945.28
2143,332,28226.44,2026-04-25,142718.84
2144,332,22402.25,2029-10-10,120316.59
2145,333,73067.25,2025-08-18,318433.86
2146,333,48023.21,2026-05-08,270410.65
2147,333,45408.11,2026-08-01,225002.54
2148,333,53453.24,2027-01-16,171549.3
2149,333,46529.37,2027-01-27,125019.93
2150,333,10797.15,2028-01-09,114222.78
2151,333,6017.02,2029-03-22,108205.76
2152,333,12789.84,2030-05-19,95415.92
2153,333,12863.6,2031-02-20,82552.32
2154,334,58338.21,2024-05-11,274225.55
2155,334,58225.07,2024-08-19,216000.48
2156,334,62330.56,2025-04-01,153669.92
2157,334,12308.02,2025-04-21,141361.9
2158,334,38177.72,2025-04-29,103184.18
2159,334,25420.88,2025-06-30,77763.3
2160,334,19303.82,2025-09-22,58459.48
2161,334,11124.11,2025-10-16,47335.37
2162,334,12437.58,2025-11-22,34897.79
2163,334,5777.61,2026-04-20,29120.18
2164,335,21703.34,2021-07-13,87579.31
2165,335,9375.04,2021-09-05,78204.27
2166,335,16876.56,2021-12-29,61327.71
2167,335,17043.9,2022-01-30,44283.81
2168,335,8700.1,2023-09-28,35583.71
2169,335,10183.73,2026-03-12,25399.98
2170,335,2792.49,2026-07-25,22607.49
2171,336,24244.09,2022-09-20,255184.99
2172,336,24632.57,2023-05-20,230552.42
2173,336,43872.4,2023-10-31,186680.02
2174,337,2256.26,2023-12-25,27111.51
2175,337,3370.64,2024-12-25,23740.87
2176,337,3726.13,2025-02-23,20014.74
2177,337,3207.88,2026-01-24,16806.86
2178,337,3401.86,2026-04-15,13405.0
2179,337,4002.88,2026-05-11,9402.12
2180,337,2227.93,2027-09-04,7174.19
2181,337,435.54,2028-09-02,6738.65
2182,337,1429.31,2028-12-31,5309.34
2183,338,22977.52,2021-03-31,150675.09
2184,338,11838.92,2021-07-13,138836.17
2185,338,36981.7,2022-02-19,101854.47
2186,338,26464.69,2022-08-09,75389.78
2187,338,4204.58,2025-10-01,71185.2
2188,338,14578.89,2026-12-16,56606.31
2189,338,12493.35,2027-06-13,44112.96
2190,339,118462.55,2021-09-23,287199.81
2191,339,23719.36,2022-03-02,263480.45
2192,339,65069.85,2023-06-27,198410.6
2193,339,11064.39,2025-03-15,187346.21
2194,339,11875.46,2028-07-02,175470.75
2195,340,66090.22,2025-06-18,391386.09
2196,340,99213.78,2026-03-10,292172.31
2197,340,70448.91,2027-04-20,221723.4
2198,340,54239.78,2029-09-05,167483.62
2199,340,36329.41,2030-05-23,131154.21
2200,340,22422.5,2031-05-07,108731.71
2201,340,31266.29,2033-03-16,77465.42
2202,341,22285.07,2021-11-24,384017.61
2203,341,61165.39,2022-06-16,322852.22
2204,341,64576.07,2022-09-22,258276.15
2205,341,71721.19,2023-02-24,186554.96
2206,341,33997.84,2023-09-27,152557.12
2207,341,17412.4,2024-01-27,135144.72
2208,341,27606.35,2024-07-04,107538.37
2209,341,22879.8,2024-11-06,84658.57
2210,341,16669.82,2025-05-22,67988.75
2211,341,10249.85,2025-08-13,57738.9
2212,342,57966.75,2024-06-16,368286.09
2213,342,28157.28,2024-12-07,340128.81
2214,342,73926.96,2025-05-02,266201.85
2215,342,13777.96,2025-06-01,252423.89
2216,342,35796.23,2025-06-07,216627.66
2217,342,35765.46,2027-10-07,180862.2
2218,342,53468.05,2028-05-30,127394.15
2219,342,37719.12,2029-03-05,89675.03
2220,343,393.05,2025-02-13,1161.96
2221,343,317.91,2025-06-11,844.05
2222,343,247.84,2025-07-10,596.21
2223,344,8695.56,2022-05-04,30875.7
2224,344,8469.73,2026-01-06,22405.97
2225,344,2398.63,2026-04-27,20007.34
2226,344,1425.28,2027-02-26,18582.06
2227,344,3070.74,2027-09-23,15511.32
2228,344,1485.94,2029-04-07,14025.38
2229,344,1435.63,2030-06-11,12589.75
2230,344,2137.35,2030-10-22,10452.4
2231,345,48615.22,2026-04-14,255013.44
2232,345,66255.15,2026-10-28,188758.29
2233,345,42344.41,2027-03-05,146413.88
2234,345,36169.63,2027-10-29,110244.25
2235,345,27413.04,2028-03-26,82831.21
2236,346,42537.65,2020-08-24,235038.24
2237,346,27667.62,2020-09-04,207370.62
2238,346,43253.07,2020-11-24,164117.55
2239,346,20259.03,2020-12-12,143858.52
2240,346,14476.38,2021-01-21,129382.14
2241,346,6807.35,2021-03-06,122574.79
2242,346,36122.17,2021-05-13,86452.62
2243,346,25897.75,2021-05-16,60554.87
2244,346,15476.13,2021-06-30,45078.74
2245,346,6384.14,2021-07-06,38694.6
2246,347,64745.39,2023-01-14,403154.47
2247,347,115382.15,2024-03-16,287772.32
2248,347,83307.48,2025-12-15,204464.84
2249,347,60096.67,2026-09-14,144368.17
2250,347,38402.34,2026-11-14,105965.83
2251,347,28177.31,2027-07-24,77788.52
2252,348,5865.37,2024-04-10,55321.43
2253,348,5285.28,2024-06-12,50036.15
2254,348,9708.52,2024-09-17,40327.63
2255,348,3924.23,2025-04-06,36403.4
2256,348,2297.91,2025-04-10,34105.49
2257,348,7544.47,2025-07-25,26561.02
2258,348,6759.04,2025-08-08,19801.98
2259,348,3073.37,2025-08-14,16728.61
2260,348,4084.68,2025-08-24,12643.93
2261,348,2206.96,2025-10-12,10436.97
2262,349,5050.81,2030-10-17,74697.64
2263,349,9956.95,2031-08-30,64740.69
2264,349,3269.69,2031-09-19,61471.0
2265,349,9080.48,2032-01-19,52390.52
2266,350,33080.58,2024-12-23,445080.75
2267,350,110473.91,2029-07-21,334606.84
2268,350,64951.81,2031-04-15,269655.03
2269,350,70307.74,2031-08-16,199347.29
2270,351,21118.43,2024-05-10,137385.8
2271,351,24525.19,2024-06-02,112860.61
2272,351,24292.73,2024-09-15,88567.88
2273,351,25346.71,2025-10-10,63221.17
2274,351,16934.28,2026-03-25,46286.89
2275,351,8740.53,2026-04-01,37546.36
2276,351,2003.03,2026-04-06,35543.33
2277,352,18513.31,2023-09-19,193545.37
2278,352,16205.9,2023-10-01,177339.47
2279,352,45210.22,2026-02-25,132129.25
2280,353,77313.41,2023-01-24,213253.55
2281,353,13745.51,2025-02-25,199508.04
2282,353,12762.84,2026-09-01,186745.2
2283,353,16573.2,2027-01-10,170172.0
2284,354,50191.64,2024-01-11,431653.31
2285,354,88620.18,2024-07-28,343033.13
2286,354,39747.95,2025-01-27,303285.18
2287,354,66967.85,2027-02-16,236317.33
2288,354,47396.72,2027-09-13,188920.61
2289,355,81351.61,2024-02-25,310361.27
2290,355,69726.53,2024-03-11,240634.74
2291,355,36924.1,2024-05-03,203710.64
2292,355,42120.87,2024-08-23,161589.77
2293,355,9499.39,2024-10-03,152090.38
2294,355,37237.54,2024-10-22,114852.84
2295,355,31464.26,2024-12-18,83388.58
2296,355,11091.95,2025-01-24,72296.63
2297,356,65209.69,2024-02-04,216344.57
2298,356,64801.07,2024-03-22,151543.5
2299,356,31541.52,2025-02-02,120001.98
2300,356,35242.25,2026-05-22,84759.73
2301,356,8425.77,2027-01-16,76333.96
2302,356,11309.48,2027-09-21,65024.48
2303,356,12514.02,2028-06-08,52510.46
2304,356,9133.31,2029-05-31,43377.15
2305,356,7163.76,2029-08-02,36213.39
2306,357,43695.27,2021-10-07,103137.48
2307,357,13588.91,2021-12-01,89548.57
2308,357,19380.5,2021-12-21,70168.07
2309,357,3713.77,2022-09-04,66454.3
2310,357,15574.6,2023-01-10,50879.7
2311,357,8360.68,2023-05-14,42519.02
2312,357,12053.72,2023-07-23,30465.3
2313,357,7154.17,2023-07-24,23311.13
2314,358,57602.81,2023-01-21,162114.13
2315,358,48523.08,2023-06-06,113591.05
2316,358,7345.68,2023-06-20,106245.37
2317,358,25333.9,2023-07-11,80911.47
2318,358,14800.46,2023-10-21,66111.01
2319,359,36155.79,2022-12-28,208723.92
2320,359,11843.01,2024-05-14,196880.91
2321,359,28903.59,2024-08-19,167977.32
2322,360,43289.33,2021-06-04,245393.24
2323,360,13906.3,2021-07-08,231486.94
2324,360,15316.95,2021-10-23,216169.99
2325,360,31476.42,2022-03-20,184693.57
2326,360,11408.56,2022-06-16,173285.01
2327,361,4325.54,2025-10-28,19998.32
2328,361,4743.39,2026-10-27,15254.93
2329,361,1723.46,2027-06-14,13531.47
2330,361,846.52,2028-06-26,12684.95
2331,361,1340.92,2028-10-06,11344.03
2332,361,1256.87,2029-12-11,10087.16
2333,362,71673.96,2023-02-15,304898.4
2334,362,61920.52,2024-06-03,242977.88
2335,362,59900.64,2025-10-05,183077.24
2336,362,13698.92,2026-09-13,169378.32
2337,363,3232.53,2024-01-15,21083.54
2338,363,1362.67,2029-11-12,19720.87
2339,363,5526.17,2030-01-07,14194.7
2340,363,4013.2,2030-07-16,10181.5
2341,364,68427.43,2023-11-26,201936.7
2342,364,17348.64,2024-10-25,184588.06
2343,364,18859.79,2026-10-18,165728.27
2344,364,19020.83,2027-03-31,146707.44
2345,364,12189.38,2027-07-25,134518.06
2346,364,30625.21,2030-08-13,103892.85
2347,365,8477.08,2021-12-09,125532.5
2348,365,19392.69,2022-01-09,106139.81
2349,365,29423.44,2022-05-11,76716.37
2350,366,26229.1,2022-02-08,302581.03
2351,366,30392.41,2023-03-01,272188.62
2352,366,32301.31,2023-04-07,239887.31
2353,367,6469.22,2024-02-24,22486.21
2354,367,1536.43,2024-10-02,20949.78
2355,367,4337.09,2025-07-17,16612.69
2356,367,2027.76,2026-12-25,14584.93
2357,367,2524.31,2027-11-26,12060.62
2358,367,2760.15,2028-12-23,9300.47
2359,368,7740.5,2025-12-03,38210.46
2360,368,1932.25,2026-03-23,36278.21
2361,368,9566.06,2026-11-27,26712.15
2362,368,2339.46,2031-03-23,24372.69
2363,369,13246.29,2024-06-28,56862.54
2364,369,9067.44,2025-03-30,47795.1
2365,369,13657.87,2025-11-23,34137.23
2366,369,1883.47,2026-01-14,32253.76
2367,369,3748.69,2026-01-29,28505.07
2368,369,8404.75,2027-05-28,20100.32
2369,369,5998.74,2028-01-05,14101.58
2370,370,36540.64,2025-05-30,141605.55
2371,370,41726.33,2027-07-07,99879.22
2372,370,7250.56,2031-02-01,92628.66
2373,370,21625.76,2031-04-05,71002.9
2374,370,10048.6,2032-01-20,60954.3
2375,371,32101.1,2025-01-01,135508.88
2376,371,15167.41,2025-06-09,120341.47
2377,371,23601.62,2025-09-13,96739.85
2378,371,6248.1,2026-02-27,90491.75
2379,371,11065.25,2027-02-14,79426.5
2380,372,12536.97,2024-01-23,31008.68
2381,372,3842.08,2024-04-11,27166.6
2382,372,4106.41,2024-06-22,23060.19
2383,372,3045.92,2024-10-10,20014.27
2384,372,2927.41,2024-12-29,17086.86
2385,372,1323.83,2025-01-19,15763.03
2386,372,3190.77,2025-02-12,12572.26
2387,372,2557.79,2025-10-18,10014.47
2388,372,1122.59,2026-02-16,8891.88
2389,373,79848.31,2022-07-28,188871.08
2390,373,28614.21,2022-09-12,160256.87
2391,373,20988.15,2024-04-21,139268.72
2392,373,13167.78,2025-05-03,126100.94
2393,373,13507.57,2026-02-16,112593.37
2394,374,89184.68,2021-12-15,225384.62
2395,374,51875.81,2022-10-26,173508.81
2396,374,37930.59,2023-04-19,135578.22
2397,374,20654.43,2024-10-23,114923.79
2398,374,12160.98,2024-11-14,102762.81
2399,374,27878.15,2024-12-03,74884.66
2400,374,13524.77,2025-03-29,61359.89
2401,374,6963.21,2025-07-13,54396.68
2402,374,15215.52,2025-08-08,39181.16
2403,375,92732.76,2024-06-20,267897.54
2404,375,76836.13,2024-07-11,191061.41
2405,375,22620.1,2024-11-03,168441.31
2406,375,36946.46,2025-03-08,131494.85
2407,375,14296.2,2025-03-17,117198.65
2408,375,28678.74,2025-03-18,88519.91
2409,375,5744.38,2025-08-14,82775.53
2410,375,22784.14,2025-08-24,59991.39
2411,376,25585.83,2025-08-08,351144.79
2412,376,91664.27,2025-10-04,259480.52
2413,376,34695.16,2025-10-16,224785.36
2414,376,20507.99,2025-11-09,204277.37
2415,376,33104.12,2025-12-18,171173.25
2416,376,31421.7,2026-01-29,139751.55
2417,377,3476.25,2023-05-25,13626.56
2418,377,2320.69,2023-08-10,11305.87
2419,377,1833.2,2026-07-22,9472.67
2420,377,1185.19,2027-05-27,8287.48
2421,378,75951.71,2021-06-06,193446.57
2422,378,10544.88,2023-06-18,182901.69
2423,378,31257.35,2023-11-20,151644.34
2424,378,11900.1,2024-11-22,139744.24
2425,379,33324.57,2025-06-28,195329.39
2426,379,38471.95,2026-04-19,156857.44
2427,379,18874.49,2026-06-21,137982.95
2428,379,10501.03,2027-05-09,127481.92
2429,379,24926.38,2027-10-14,102555.54
2430,380,15528.53,2024-11-16,56709.16
2431,380,3589.71,2025-05-11,53119.45
2432,380,9176.11,2026-10-19,43943.34
2433,380,6569.85,2027-02-09,37373.49
2434,380,10094.94,2028-07-30,27278.55
2435,380,2076.97,2028-12-08,25201.58
2436,380,5778.25,2029-02-21,19423.33
2437,380,3120.13,2030-01-03,16303.2
2438,380,1946.94,2031-08-30,14356.26
2439,380,1353.35,2031-09-25,13002.91
2440,381,17512.61,2022-07-21,169821.43
2441,381,13524.4,2025-12-21,156297.03
2442,381,38349.95,2026-07-04,117947.08
2443,381,26238.71,2030-07-18,91708.37
2444,382,27822.24,2021-08-18,85536.95
2445,382,18008.0,2021-11-16,67528.95
2446,382,18976.93,2022-01-06,48552.02
2447,382,8591.4,2022-01-13,39960.62
2448,382,11658.66,2022-01-25,28301.96
2449,382,4181.16,2022-03-11,24120.8
2450,382,2517.04,2022-10-04,21603.76
2451,382,2362.15,2023-02-01,19241.61
2452,382,1657.38,2023-02-18,17584.23
2453,382,3198.32,2023-10-27,14385.91
2454,383,9486.17,2022-08-27,163893.21
2455,383,28446.94,2022-12-17,135446.27
2456,383,32226.69,2023-01-29,103219.58
2457,383,23035.24,2024-12-31,80184.34
2458,383,23755.06,2026-01-14,56429.28
2459,383,11454.22,2026-02-25,44975.06
2460,383,6529.35,2026-02-26,38445.71
2461,383,9252.43,2026-08-23,29193.28
2462,384,51104.07,2024-06-27,142236.36
2463,384,13594.1,2025-02-03,128642.26
2464,384,36980.1,2025-02-06,91662.16
2465,384,11290.43,2025-05-28,80371.73
2466,384,19006.44,2025-08-08,61365.29
2467,384,13123.03,2025-12-23,48242.26
2468,385,8155.03,2024-12-11,77970.49
2469,385,11532.08,2025-05-10,66438.41
2470,385,11960.55,2025-06-09,54477.86
2471,385,9886.29,2027-02-06,44591.57
2472,385,6800.39,2029-10-15,37791.18
2473,385,3729.08,2031-09-25,34062.1
2474,385,6145.57,2031-10-26,27916.53
2475,385,5328.08,2032-01-24,22588.45
2476,386,12926.65,2023-06-30,67280.36
2477,386,3995.41,2023-07-28,63284.95
2478,386,3353.36,2023-10-27,59931.59
2479,386,16730.53,2025-02-14,43201.06
2480,386,2968.95,2028-04-28,40232.11
2481,386,4434.05,2028-12-13,35798.06
2482,386,10071.14,2029-08-24,25726.92
2483,386,3964.04,2030-06-29,21762.88
2484,386,4718.23,2031-01-25,17044.65
2485,386,2351.52,2032-04-24,14693.13
2486,387,115799.64,2024-03-22,346403.2
2487,387,76143.96,2024-10-30,270259.24
2488,387,35975.57,2026-03-09,234283.67
2489,387,60569.56,2027-03-31,173714.11
2490,387,21432.51,2028-06-30,152281.6
2491,388,42958.76,2024-12-28,379030.35
2492,388,71688.03,2025-08-21,307342.32
2493,388,35144.17,2025-10-03,272198.15
2494,388,50740.3,2025-11-04,221457.85
2495,388,39255.38,2025-11-10,182202.47
2496,389,43466.37,2025-02-11,228660.11
2497,389,11945.2,2026-03-09,216714.91
2498,389,21941.95,2026-03-31,194772.96
2499,389,18010.3,2026-09-21,176762.66
2500,389,47930.22,2027-09-14,128832.44
2501,389,8238.2,2028-01-26,120594.24
2502,389,18961.0,2029-02-13,101633.24
2503,389,24936.58,2029-07-27,76696.66
2504,390,86770.74,2022-02-22,396344.51
2505,390,113062.31,2022-11-15,283282.2
2506,390,27560.83,2025-03-18,255721.37
2507,391,34877.62,2023-07-25,147604.32
2508,391,29985.89,2023-09-26,117618.43
2509,391,33833.12,2024-02-03,83785.31
2510,391,4220.93,2024-05-01,79564.38
2511,391,21975.11,2026-06-11,57589.27
2512,391,6467.21,2028-01-18,51122.06
2513,391,8805.56,2030-01-29,42316.5
2514,391,11384.49,2030-06-19,30932.01
2515,392,19087.66,2022-09-02,143498.54
2516,392,15078.89,2022-12-04,128419.65
2517,392,26245.22,2022-12-11,102174.43
2518,392,9994.46,2022-12-20,92179.97
2519,392,7886.41,2023-02-13,84293.56
2520,392,5049.17,2023-03-22,79244.39
2521,392,13486.59,2023-04-03,65757.8
2522,392,10740.74,2023-05-27,55017.06
2523,392,9388.95,2023-06-30,45628.11
2524,392,11042.24,2023-08-02,34585.87
2525,393,27206.14,2024-03-30,81701.47
2526,393,7018.0,2024-04-06,74683.47
2527,393,4714.5,2024-12-08,69968.97
2528,394,5464.19,2022-10-19,79671.35
2529,394,10719.5,2023-03-01,68951.85
2530,394,18213.01,2023-10-07,50738.84
2531,395,30975.24,2021-11-29,120953.76
2532,395,21850.87,2021-12-07,99102.89
2533,395,5357.77,2021-12-21,93745.12
2534,395,20824.74,2021-12-22,72920.38
2535,395,11411.52,2022-02-13,61508.86
2536,395,12078.66,2022-02-25,49430.2
2537,395,7163.23,2022-04-09,42266.97
2538,395,5010.54,2022-08-19,37256.43
2539,396,9939.73,2020-12-24,119514.6
2540,396,30131.14,2022-06-04,89383.46
2541,396,26487.79,2022-10-12,62895.67
2542,396,7649.01,2022-11-25,55246.66
2543,396,6363.45,2023-01-07,48883.21
2544,396,5292.33,2023-10-31,43590.88
2545,397,25196.51,2023-08-27,120194.98
2546,397,14060.68,2025-08-19,106134.3
2547,397,15763.22,2025-08-27,90371.08
2548,398,87288.1,2025-01-14,229639.84
2549,398,16255.5,2025-03-20,213384.34
2550,398,30887.69,2025-04-10,182496.65
2551,398,27268.51,2025-09-21,155228.14
2552,399,39093.45,2023-12-05,130253.67
2553,399,35273.4,2024-03-21,94980.27
2554,399,7264.74,2024-06-13,87715.53
2555,399,16064.53,2024-10-20,71651.0
2556,399,8702.44,2024-11-22,62948.56
2557,399,6201.1,2024-12-06,56747.46
2558,399,13143.87,2025-02-06,43603.59
2559,399,3460.08,2025-02-16,40143.51
2560,399,5058.07,2025-03-12,35085.44
2561,399,9250.12,2025-05-14,25835.32
2562,400,101891.88,2024-10-15,306049.79
2563,400,85254.93,2025-07-20,220794.86
2564,400,34188.67,2026-05-23,186606.19
2565,400,18169.8,2027-11-24,168436.39
2566,401,44981.2,2024-05-03,254088.63
2567,401,63981.56,2024-07-01,190107.07
2568,401,49850.35,2024-07-29,140256.72
2569,401,40062.71,2024-09-07,100194.01
2570,401,9960.29,2024-10-05,90233.72
2571,401,17455.98,2024-10-18,72777.74
2572,402,91752.41,2020-09-19,323622.59
2573,402,52632.03,2021-10-15,270990.56
2574,402,75582.95,2021-12-12,195407.61
2575,402,16137.9,2022-09-05,179269.71
2576,402,12899.84,2023-08-08,166369.87
2577,402,44370.77,2023-09-30,121999.1
2578,403,5148.82,2026-07-08,13721.76
2579,403,3853.34,2027-06-29,9868.42
2580,403,1098.73,2028-02-22,8769.69
2581,403,1989.53,2029-07-03,6780.16
2582,403,1820.51,2032-04-21,4959.65
2583,403,1460.13,2032-08-18,3499.52
2584,403,851.13,2033-02-16,2648.39
2585,403,667.65,2033-06-23,1980.74
2586,404,48257.63,2022-01-18,212793.29
2587,404,45617.47,2022-09-25,167175.82
2588,404,31036.54,2023-11-02,136139.28
2589,404,32747.87,2024-05-14,103391.41
2590,404,22444.31,2024-06-03,80947.1
2591,404,9265.11,2024-07-13,71681.99
2592,404,15542.87,2025-11-15,56139.12
2593,404,8510.42,2027-02-16,47628.7
2594,405,20369.56,2024-06-23,298916.1
2595,405,64092.85,2024-09-16,234823.25
2596,405,54003.37,2025-10-04,180819.88
2597,405,49329.11,2026-07-05,131490.77
2598,405,10573.37,2026-10-04,120917.4
2599,405,8079.84,2027-09-16,112837.56
2600,405,31596.54,2027-11-09,81241.02
2601,405,5639.62,2028-02-16,75601.4
2602,405,21515.24,2028-02-19,54086.16
2603,406,22361.35,2024-05-18,243706.35
2604,406,66491.21,2024-11-25,177215.14
2605,406,16245.49,2025-08-02,160969.65
2606,406,39049.88,2026-07-30,121919.77
2607,406,32446.41,2026-10-22,89473.36
2608,407,84394.93,2021-01-10,240382.68
2609,407,23682.62,2022-05-11,216700.06
2610,407,16782.22,2024-10-30,199917.84
2611,408,53222.88,2025-09-21,259313.43
2612,408,16988.66,2026-11-08,242324.77
2613,408,29459.73,2028-03-13,212865.04
2614,408,19228.47,2029-09-26,193636.57
2615,408,22923.46,2030-01-14,170713.11
2616,408,21423.95,2031-01-06,149289.16
2617,408,20494.37,2032-08-18,128794.79
2618,409,3062.87,2022-09-10,8336.21
2619,409,1437.86,2023-05-01,6898.35
2620,409,744.66,2023-11-29,6153.69
2621,409,903.72,2024-07-22,5249.97
2622,409,1051.36,2025-06-03,4198.61
2623,409,1138.51,2025-07-05,3060.1
2624,410,37606.24,2021-09-08,333942.61
2625,410,18334.89,2022-09-27,315607.72
2626,410,20358.45,2023-04-01,295249.27
2627,410,45780.75,2024-03-07,249468.52
2628,411,34306.77,2022-01-24,123029.79
2629,411,6697.29,2022-02-11,116332.5
2630,411,19419.73,2022-03-23,96912.77
2631,411,10555.32,2022-09-08,86357.45
2632,411,14646.35,2022-11-01,71711.1
2633,412,98332.86,2021-08-05,299408.28
2634,412,89721.6,2021-10-24,209686.68
2635,412,38044.61,2022-07-03,171642.07
2636,412,27856.53,2022-07-22,143785.54
2637,412,38066.17,2022-08-22,105719.37
2638,412,14946.98,2022-12-10,90772.39
2639,412,14276.88,2023-01-21,76495.51
2640,412,22786.39,2023-06-03,53709.12
2641,412,3939.13,2023-12-01,49769.99
2642,413,31756.9,2026-11-26,303118.95
2643,413,40529.93,2029-10-19,262589.02
2644,413,58857.47,2030-07-18,203731.55
2645,413,47786.45,2032-01-19,155945.1
2646,413,36113.07,2033-07-22,119832.03
2647,413,9521.23,2034-01-15,110310.8
2648,414,3895.14,2020-09-11,24008.42
2649,414,2738.94,2022-03-24,21269.48
2650,414,3547.28,2022-08-23,17722.2
2651,414,1212.41,2024-09-26,16509.79
2652,414,1019.65,2025-12-20,15490.14
2653,414,1733.73,2026-03-06,13756.41
2654,414,3633.58,2027-03-20,10122.83
2655,414,1561.71,2028-04-26,8561.12
2656,415,7888.73,2021-10-11,26707.93
2657,415,2814.13,2022-09-04,23893.8
2658,415,3602.87,2024-04-16,20290.93
2659,415,5101.14,2024-11-15,15189.79
2660,415,1548.86,2025-12-14,13640.93
2661,415,1976.42,2026-12-02,11664.51
2662,415,3469.48,2027-01-24,8195.03
2663,415,970.76,2027-03-13,7224.27
2664,416,9652.75,2021-05-25,27430.91
2665,416,2580.78,2021-09-02,24850.13
2666,416,4414.43,2022-11-29,20435.7
2667,417,20542.58,2024-02-15,151638.02
2668,417,35830.21,2024-07-03,115807.81
2669,417,34280.87,2024-08-27,81526.94
2670,417,8442.3,2024-09-23,73084.64
2671,417,18231.03,2024-11-03,54853.61
2672,417,14619.67,2025-12-28,40233.94
2673,418,45125.07,2022-09-05,269407.87
2674,418,41137.08,2022-12-08,228270.79
2675,418,60145.1,2023-01-03,168125.69
2676,418,30394.07,2023-05-18,137731.62
2677,418,29779.23,2024-01-29,107952.39
2678,418,9864.95,2024-07-23,98087.44
2679,418,16480.74,2025-01-15,81606.7
2680,418,5821.33,2025-02-27,75785.37
2681,418,7234.83,2025-11-14,68550.54
2682,419,43763.96,2021-08-16,198069.83
2683,419,41280.0,2022-07-21,156789.83
2684,419,46970.01,2023-01-05,109819.82
2685,419,25843.4,2023-07-02,83976.42
2686,419,15178.9,2023-11-01,68797.52
2687,419,8519.77,2024-03-08,60277.75
2688,420,42426.76,2021-08-05,100084.44
2689,420,10517.89,2023-09-07,89566.55
2690,420,24295.87,2023-09-08,65270.68
2691,421,1374.19,2025-07-31,8206.16
2692,421,2430.59,2026-03-21,5775.57
2693,421,1425.96,2026-07-31,4349.61
2694,421,223.7,2027-09-04,4125.91
2695,422,134156.02,2020-08-21,327159.96
2696,422,91842.48,2022-12-17,235317.48
2697,422,54497.81,2024-02-05,180819.67
2698,422,17627.31,2025-02-28,163192.36
2699,423,22602.29,2021-09-26,314086.1
2700,423,41018.67,2022-02-09,273067.43
2701,423,35105.1,2022-08-17,237962.33
2702,423,60279.82,2023-01-08,177682.51
2703,424,19339.35,2021-03-15,327452.05
2704,424,26212.21,2021-05-29,301239.84
2705,424,46456.54,2021-06-11,254783.3
2706,424,36861.35,2021-11-08,217921.95
2707,424,37376.54,2023-10-16,180545.41
2708,425,60148.6,2022-12-25,159644.66
2709,425,45203.66,2023-02-12,114441.0
2710,425,33868.61,2023-06-10,80572.39
2711,425,22692.9,2023-12-29,57879.49
2712,425,6440.57,2024-06-03,51438.92
2713,425,4357.97,2024-07-01,47080.95
2714,426,12943.72,2025-02-01,143004.13
2715,426,25595.51,2027-04-20,117408.62
2716,426,14720.72,2027-11-28,102687.9
2717,426,25763.58,2030-12-11,76924.32
2718,427,47680.46,2021-12-15,400908.97
2719,427,78868.01,2022-06-18,322040.96
2720,427,24585.65,2022-12-21,297455.31
2721,427,53456.34,2024-11-03,243998.97
2722,427,15957.36,2025-01-11,228041.61
2723,427,56383.11,2025-04-12,171658.5
2724,428,12331.22,2025-10-07,228215.51
2725,428,38666.56,2026-11-05,189548.95
2726,428,47151.21,2027-02-09,142397.74
2727,428,14198.24,2028-02-12,128199.5
2728,428,29714.17,2028-07-11,98485.33
2729,428,26580.62,2028-11-16,71904.71
2730,428,6310.73,2029-01-07,65593.98
2731,428,12059.65,2031-01-11,53534.33
2732,428,9377.37,2031-02-23,44156.96
2733,428,7902.62,2032-02-29,36254.34
2734,429,88542.93,2024-08-20,308041.86
2735,429,90699.12,2025-05-10,217342.74
2736,429,47017.94,2025-07-07,170324.8
2737,429,31393.59,2027-10-29,138931.21
2738,429,10169.34,2029-02-24,128761.87
2739,429,13883.37,2029-12-28,114878.5
2740,429,19239.06,2031-04-27,95639.44
2741,430,47034.32,2026-06-11,177941.44
2742,430,10345.07,2028-04-21,167596.37
2743,430,42645.07,2030-11-20,124951.3
2744,431,103952.43,2025-07-28,301441.57
2745,431,18757.17,2025-11-05,282684.4
2746,431,35130.69,2026-08-04,247553.71
2747,431,25520.46,2026-08-29,222033.25
2748,431,32490.53,2027-03-08,189542.72
2749,431,23831.99,2027-10-04,165710.73
2750,431,20496.82,2027-10-08,145213.91
2751,431,40016.85,2028-04-09,105197.06
2752,431,18431.74,2028-04-24,86765.32
2753,431,11351.03,2028-05-15,75414.29
2754,432,50302.98,2024-06-01,148881.78
2755,432,31125.64,2024-06-24,117756.14
2756,432,24068.4,2025-06-12,93687.74
2757,432,25165.87,2027-05-02,68521.87
2758,432,19628.98,2027-08-15,48892.89
2759,432,12473.45,2028-06-04,36419.44
2760,432,9568.07,2029-05-04,26851.37
2761,433,86144.08,2023-09-06,229381.03
2762,433,26221.66,2023-10-04,203159.37
2763,433,19344.31,2024-11-23,183815.06
2764,433,9701.4,2026-03-06,174113.66
2765,433,36102.26,2026-04-16,138011.4
2766,433,22170.6,2026-08-14,115840.8
2767,433,6779.71,2028-07-07,109061.09
2768,433,6241.31,2028-12-13,102819.78
2769,433,25246.83,2029-08-08,77572.95
2770,433,12697.86,2030-04-30,64875.09
2771,434,35922.66,2022-12-04,427733.22
2772,434,113831.37,2023-01-28,313901.85
2773,434,33158.08,2023-06-19,280743.77
2774,434,62322.78,2023-10-06,218420.99
2775,434,19601.41,2024-01-17,198819.58
2776,434,26571.56,2025-01-30,172248.02
2777,434,39661.68,2025-05-24,132586.34
2778,434,37584.94,2025-06-03,95001.4
2779,434,9025.74,2025-09-20,85975.66
2780,435,27016.42,2024-12-20,210145.84
2781,435,46713.61,2025-04-26,163432.23
2782,435,29523.63,2025-06-11,133908.6
2783,436,45963.2,2023-12-31,306322.01
2784,436,77133.44,2024-02-29,229188.57
2785,436,36802.07,2025-02-04,192386.5
2786,436,51941.13,2026-06-04,140445.37
2787,436,28447.04,2026-08-10,111998.33
2788,436,31895.38,2028-01-20,80102.95
2789,436,11074.74,2030-04-07,69028.21
2790,436,9783.66,2030-07-31,59244.55
2791,437,18245.97,2025-01-17,82622.45
2792,437,21364.42,2025-04-26,61258.03
2793,437,10435.46,2026-07-18,50822.57
2794,437,4873.03,2026-11-20,45949.54
2795,437,4945.09,2027-07-22,41004.45
2796,437,5471.36,2028-01-23,35533.09
2797,437,5861.32,2028-10-10,29671.77
2798,437,7920.78,2028-10-21,21750.99
2799,437,2196.0,2029-01-28,19554.99
2800,437,5555.27,2029-02-12,13999.72
2801,438,1438.75,2024-08-15,24807.57
2802,438,4897.01,2025-10-05,19910.56
2803,438,1980.03,2027-10-23,17930.53
2804,438,2164.06,2029-05-08,15766.47
2805,438,2243.92,2029-07-02,13522.55
2806,438,2608.28,2030-10-26,10914.27
2807,438,2381.22,2031-09-22,8533.05
2808,438,1022.22,2032-11-12,7510.83
2809,439,42206.24,2022-11-25,107377.91
2810,439,15820.04,2025-10-17,91557.87
2811,439,4834.75,2026-05-06,86723.12
2812,440,23051.88,2022-06-12,187270.04
2813,440,33931.84,2023-02-14,153338.2
2814,440,9170.27,2023-05-26,144167.93
2815,440,33734.75,2023-08-12,110433.18
2816,440,15867.59,2030-01-08,94565.59
2817,440,17072.13,2030-05-18,77493.46
2818,440,15774.23,2030-11-12,61719.23
2819,440,15026.52,2031-01-04,46692.71
2820,441,42819.51,2023-06-07,301435.05
2821,441,18710.52,2023-06-12,282724.53
2822,441,48836.56,2023-07-27,233887.97
2823,441,50912.07,2023-12-25,182975.9
2824,441,14445.41,2024-02-01,168530.49
2825,441,48424.15,2024-05-07,120106.34
2826,441,6958.71,2024-05-12,113147.63
2827,441,7763.97,2024-05-14,105383.66
2828,441,8872.85,2025-01-13,96510.81
2829,442,16272.49,2022-08-01,297931.02
2830,442,21679.11,2024-02-10,276251.91
2831,442,35446.02,2024-06-10,240805.89
2832,442,39471.5,2024-07-09,201334.39
2833,442,39207.07,2024-08-28,162127.32
2834,442,48096.24,2027-11-11,114031.08
2835,443,26878.17,2024-05-23,71621.47
2836,443,16130.91,2024-07-29,55490.56
2837,443,10663.42,2024-08-07,44827.14
2838,443,12167.17,2024-08-30,32659.97
2839,443,5488.84,2024-10-27,27171.13
2840,443,5826.93,2024-11-13,21344.2
2841,443,3851.29,2024-11-29,17492.91
2842,443,3540.3,2024-12-04,13952.61
2843,443,2185.64,2025-04-09,11766.97
2844,443,2120.59,2025-06-23,9646.38
2845,444,94997.77,2020-11-14,286052.97
2846,444,84872.98,2021-01-04,201179.99
2847,444,57628.96,2021-03-03,143551.03
2848,444,24003.43,2021-03-06,119547.6
2849,444,7624.67,2021-03-08,111922.93
2850,444,16441.08,2021-08-02,95481.85
2851,444,11284.42,2022-04-28,84197.43
2852,444,8976.61,2022-08-20,75220.82
2853,445,97186.69,2024-04-27,388213.73
2854,445,26828.31,2026-07-20,361385.42
2855,445,78854.11,2028-11-24,282531.31
2856,445,30012.18,2029-02-19,252519.13
2857,446,29140.15,2023-05-24,158718.47
2858,446,28472.32,2024-10-30,130246.15
2859,446,19972.69,2024-12-28,110273.46
2860,446,5796.87,2026-01-21,104476.59
2861,446,20060.24,2026-07-26,84416.35
2862,446,13835.22,2026-08-01,70581.13
2863,446,3856.73,2028-08-11,66724.4
2864,446,15434.04,2029-06-10,51290.36
2865,446,13086.87,2029-09-08,38203.49
2866,447,25488.81,2025-06-29,74960.9
2867,447,21324.14,2026-01-15,53636.76
2868,447,8477.34,2026-08-12,45159.42
2869,447,6299.13,2026-09-16,38860.29
2870,448,83822.93,2026-12-19,253668.92
2871,448,29923.71,2028-06-22,223745.21
2872,448,33861.33,2028-08-31,189883.88
2873,448,14575.74,2029-01-30,175308.14
2874,448,44395.13,2030-12-01,130913.01
2875,448,38695.77,2031-02-16,92217.24
2876,448,21343.66,2031-08-12,70873.58
2877,449,64685.9,2026-09-15,183824.43
2878,449,35164.04,2027-08-06,148660.39
2879,449,22311.1,2029-05-26,126349.29
2880,450,94727.98,2022-02-21,383231.35
2881,450,69442.71,2023-08-04,313788.64
2882,450,91860.53,2024-03-21,221928.11
2883,450,41383.5,2024-12-19,180544.61
2884,450,20490.7,2025-12-20,160053.91
2885,451,37265.91,2023-12-21,431325.73
2886,451,73746.19,2026-04-12,357579.54
2887,451,56928.37,2027-08-26,300651.17
2888,451,20665.49,2028-05-21,279985.68
2889,451,67044.26,2029-02-18,212941.42
2890,451,55559.42,2030-05-18,157382.0
2891,451,33009.85,2030-05-25,124372.15
2892,451,8285.52,2031-02-09,116086.63
2893,451,6430.21,2031-04-25,109656.42
2894,452,30128.2,2025-03-07,350572.65
2895,452,99771.8,2026-04-06,250800.85
2896,452,54804.27,2028-11-16,195996.58
2897,453,26266.33,2023-04-06,117488.41
2898,453,13467.68,2023-10-10,104020.73
2899,453,7028.55,2024-04-21,96992.18
2900,453,23147.31,2024-12-09,73844.87
2901,453,7363.11,2025-09-27,66481.76
2902,453,18109.9,2026-05-08,48371.86
2903,453,10916.63,2026-09-29,37455.23
2904,453,7429.76,2026-12-23,30025.47
2905,453,7193.1,2027-07-23,22832.37
2906,454,29623.58,2023-05-07,97361.96
2907,454,27230.98,2023-11-02,70130.98
2908,454,10937.42,2024-01-03,59193.56
2909,454,9910.09,2024-01-16,49283.47
2910,454,7084.79,2024-02-17,42198.68
2911,454,9908.81,2024-03-09,32289.87
2912,454,3530.11,2024-06-30,28759.76
2913,454,1830.72,2024-11-17,26929.04
2914,454,4975.86,2025-04-23,21953.18
2915,454,3133.66,2026-05-13,18819.52
2916,455,85581.4,2021-09-01,238369.16
2917,455,25601.08,2022-06-21,212768.08
2918,455,51136.35,2022-09-02,161631.73
2919,455,47256.15,2024-05-20,114375.58
2920,455,25454.73,2024-06-15,88920.85
2921,455,20800.25,2027-09-04,68120.6
2922,456,72355.54,2022-04-06,409417.16
2923,456,43402.86,2022-10-13,366014.3
2924,456,34589.6,2024-06-07,331424.7
2925,456,42323.95,2025-08-08,289100.75
2926,456,26585.8,2026-04-14,262514.95
2927,456,77682.27,2026-12-19,184832.68
2928,456,24106.31,2027-11-19,160726.37
2929,456,16378.87,2027-12-02,144347.5
2930,456,7287.04,2028-01-25,137060.46
2931,457,77422.23,2020-11-10,248467.9
2932,457,53571.63,2021-01-24,194896.27
2933,457,55801.91,2021-03-08,139094.36
2934,457,21057.05,2021-04-15,118037.31
2935,457,29024.24,2021-06-19,89013.07
2936,458,33896.27,2022-01-09,222514.34
2937,458,48873.23,2022-01-27,173641.11
2938,458,21419.93,2022-03-21,152221.18
2939,458,18550.95,2022-05-15,133670.23
2940,458,6963.52,2022-06-22,126706.71
2941,458,17011.52,2022-07-01,109695.19
2942,458,32787.69,2022-07-24,76907.5
2943,458,22115.89,2022-08-29,54791.61
2944,458,12459.72,2022-09-10,42331.89
2945,458,11413.71,2022-09-28,30918.18
2946,459,47651.11,2023-08-21,119627.47
2947,459,8872.18,2024-03-04,110755.29
2948,459,9652.35,2027-10-15,101102.94
2949,460,52807.0,2021-07-10,188869.22
2950,460,30657.68,2021-07-12,158211.54
2951,460,24275.26,2022-01-10,133936.28
2952,460,9882.67,2022-05-14,124053.61
2953,460,27317.12,2022-05-19,96736.49
2954,460,16371.03,2022-06-12,80365.46
2955,460,18008.43,2022-08-18,62357.03
2956,460,4373.32,2023-03-10,57983.71
2957,460,8269.03,2023-03-15,49714.68
2958,461,11380.06,2025-09-27,43423.92
2959,461,10699.31,2026-01-05,32724.61
2960,461,8537.09,2027-10-24,24187.52
2961,461,6162.78,2027-11-05,18024.74
2962,461,4584.05,2028-02-28,13440.69
2963,461,811.15,2028-05-06,12629.54
2964,461,2897.11,2029-02-06,9732.43
2965,461,2184.84,2029-03-15,7547.59
2966,462,73123.58,2022-09-03,393277.93
2967,462,115815.98,2022-12-10,277461.95
2968,462,24014.14,2023-04-10,253447.81
2969,463,21065.44,2023-02-06,120695.78
2970,463,25263.61,2023-06-07,95432.17
2971,463,6672.22,2023-08-06,88759.95
2972,463,10640.6,2023-08-18,78119.35
2973,463,15160.88,2024-03-24,62958.47
2974,464,39895.18,2024-06-24,132311.41
2975,464,25718.65,2025-10-22,106592.76
2976,464,25884.13,2026-09-25,80708.63
2977,464,12426.29,2028-03-04,68282.34
2978,465,24609.66,2021-08-26,270367.99
2979,465,51348.28,2023-03-24,219019.71
2980,465,63349.2,2023-04-07,155670.51
2981,465,34343.41,2023-12-07,121327.1
2982,465,14863.14,2024-09-16,106463.96
2983,465,18091.36,2024-12-30,88372.6
2984,466,114545.4,2025-02-10,344669.92
2985,466,41734.33,2028-09-18,302935.59
2986,466,20971.41,2029-03-04,281964.18
2987,466,67532.13,2029-06-09,214432.05
2988,466,48439.91,2030-06-14,165992.14
2989,466,25220.66,2030-08-03,140771.48
2990,466,28249.15,2030-08-24,112522.33
2991,466,21512.14,2031-05-26,91010.19
2992,466,19633.62,2031-09-02,71376.57
2993,466,19005.03,2032-10-23,52371.54
2994,467,28958.91,2024-09-13,226261.39
2995,467,41898.98,2026-01-03,184362.41
2996,467,47007.72,2027-08-02,137354.69
2997,467,37077.38,2027-11-26,100277.31
2998,467,22595.04,2028-02-26,77682.27
2999,467,8465.35,2029-01-14,69216.92
3000,467,16182.02,2029-03-22,53034.9
3001,467,6801.72,2029-06-28,46233.18
3002,467,13755.52,2029-09-21,32477.66
3003,467,4890.01,2030-03-11,27587.65
3004,468,26923.6,2025-11-10,246217.18
3005,468,46948.42,2027-04-07,199268.76
3006,468,32978.18,2027-09-09,166290.58
3007,468,48644.36,2028-05-05,117646.22
3008,468,32366.45,2028-10-07,85279.77
3009,468,8054.78,2029-08-12,77224.99
3010,469,30397.87,2023-10-13,119465.22
3011,469,7441.16,2023-11-11,112024.06
3012,469,27690.89,2024-03-31,84333.17
3013,469,22389.88,2024-05-08,61943.29
3014,469,3576.27,2025-02-24,58367.02
3015,469,10243.6,2025-05-02,48123.42
3016,469,9354.89,2025-06-28,38768.53
3017,470,61114.79,2022-12-02,153403.8
3018,470,19771.67,2023-06-26,133632.13
3019,470,9767.01,2024-02-04,123865.12
3020,470,22247.85,2026-03-19,101617.27
3021,470,19216.94,2026-05-18,82400.33
3022,470,4700.48,2026-11-10,77699.85
3023,470,12750.6,2027-05-31,64949.25
3024,471,28117.87,2021-01-06,389636.99
3025,471,78087.27,2021-03-12,311549.72
3026,471,35972.42,2021-06-09,275577.3
3027,472,23044.04,2022-08-29,128409.83
3028,472,24934.41,2024-05-14,103475.42
3029,472,9504.71,2025-01-22,93970.71
3030,472,24056.29,2025-07-24,69914.42
3031,473,9304.6,2020-12-09,58600.13
3032,473,17382.81,2022-03-14,41217.32
3033,473,10555.85,2022-03-29,30661.47
3034,473,3414.11,2023-06-15,27247.36
3035,473,3840.67,2024-09-20,23406.69
3036,473,3721.05,2025-04-16,19685.64
3037,473,1995.07,2025-06-21,17690.57
3038,473,5167.79,2025-07-23,12522.78
3039,473,832.37,2026-04-19,11690.41
3040,474,69321.75,2026-10-02,210494.55
3041,474,12876.64,2027-03-20,197617.91
3042,474,32386.03,2028-06-05,165231.88
3043,474,48571.51,2028-08-21,116660.37
3044,474,21363.84,2030-10-30,95296.53
3045,474,23573.73,2032-07-16,71722.8
3046,474,6823.72,2034-11-29,64899.08
3047,475,2543.3,2025-10-07,13608.03
3048,475,1582.41,2025-11-22,12025.62
3049,475,2711.31,2025-12-13,9314.31
3050,475,1756.52,2025-12-17,7557.79
3051,475,1662.93,2026-01-17,5894.86
3052,475,1191.85,2026-07-05,4703.01
3053,475,1319.13,2026-07-17,3383.88
3054,475,815.61,2026-11-16,2568.27
3055,475,180.81,2027-02-26,2387.46
3056,476,39642.8,2021-11-18,144389.42
3057,476,22519.3,2022-11-18,121870.12
3058,476,10928.8,2025-11-01,110941.32
3059,476,16059.11,2028-08-17,94882.21
3060,477,115565.05,2026-08-24,304403.4
3061,477,83068.94,2026-12-18,221334.46
3062,477,66068.36,2026-12-26,155266.1
3063,477,12531.08,2027-10-12,142735.02
3064,477,34601.38,2028-03-24,108133.64
3065,478,529.08,2025-06-01,1910.97
3066,478,353.97,2025-12-21,1557.0
3067,478,292.54,2027-11-02,1264.46
3068,478,66.12,2029-02-27,1198.34
3069,478,164.31,2030-10-26,1034.03
3070,478,226.2,2031-10-11,807.83
3071,478,179.1,2033-09-15,628.73
3072,479,35301.33,2025-01-31,331753.98
3073,479,92312.46,2025-11-16,239441.52
3074,479,59186.86,2026-02-18,180254.66
3075,480,4665.47,2023-04-11,34219.98
3076,480,5145.25,2023-04-14,29074.73
3077,480,1821.62,2023-07-01,27253.11
3078,480,7319.98,2023-08-29,19933.13
3079,480,5581.37,2023-10-03,14351.76
3080,480,2922.95,2023-11-06,11428.81
3081,480,999.56,2023-11-29,10429.25
3082,480,829.32,2024-01-13,9599.93
3083,480,2383.84,2024-02-01,7216.09
3084,481,1894.33,2024-10-15,8069.79
3085,481,2068.33,2025-03-31,6001.46
3086,481,397.06,2025-12-23,5604.4
3087,481,407.91,2026-11-19,5196.49
3088,481,445.96,2026-12-30,4750.53
3089,481,1015.15,2027-10-18,3735.38
3090,481,232.15,2028-07-18,3503.23
3091,481,670.38,2028-08-24,2832.85
3092,481,596.19,2029-03-06,2236.66
3093,481,125.88,2030-05-02,2110.78
3094,482,63144.7,2024-08-20,399795.64
3095,482,92789.84,2024-09-04,307005.8
3096,482,78774.03,2024-11-19,228231.77
3097,482,35747.37,2025-08-30,192484.4
3098,482,39250.6,2025-09-11,153233.8
3099,482,25896.86,2025-10-24,127336.94
3100,482,36589.51,2025-12-04,90747.43
3101,482,22168.88,2026-04-21,68578.55
3102,482,10983.45,2026-05-17,57595.1
3103,483,96429.6,2023-05-19,348912.48
3104,483,46189.42,2023-08-03,302723.06
3105,483,73694.65,2024-02-29,229028.41
3106,483,15482.66,2024-03-01,213545.75
3107,483,40446.46,2024-04-29,173099.29
3108,483,19921.54,2024-06-20,153177.75
3109,483,8818.85,2024-08-14,144358.9
3110,483,37546.88,2025-04-03,106812.02
3111,483,22731.51,2026-02-10,84080.51
3112,483,6394.34,2026-03-27,77686.17
3113,484,43477.51,2023-04-12,172746.9
3114,484,36345.41,2023-07-11,136401.49
3115,484,24511.09,2023-07-27,111890.4
3116,484,6428.55,2023-10-06,105461.85
3117,484,14021.18,2023-10-08,91440.67
3118,484,23661.65,2023-12-25,67779.02
3119,484,10229.29,2024-04-25,57549.73
3120,484,5111.73,2024-08-10,52438.0
3121,485,22188.53,2020-10-01,122673.83
3122,485,18009.81,2022-06-25,104664.02
3123,485,25051.75,2022-11-01,79612.27
3124,485,4536.72,2023-10-23,75075.55
3125,485,6977.19,2024-07-21,68098.36
3126,485,19566.08,2026-08-23,48532.28
3127,485,9779.4,2028-11-19,38752.88
3128,485,5983.54,2029-05-09,32769.34
3129,486,3570.36,2022-11-05,8432.75
3130,486,958.7,2022-12-12,7474.05
3131,486,1491.12,2023-01-16,5982.93
3132,486,1236.15,2024-01-17,4746.78
3133,486,1177.01,2024-07-08,3569.77
3134,486,406.34,2024-12-09,3163.43
3135,486,174.3,2025-06-22,2989.13
3136,487,13384.19,2025-06-04,114736.7
3137,487,18632.48,2027-05-27,96104.22
3138,487,21589.16,2027-12-17,74515.06
3139,487,9682.75,2028-11-17,64832.31
3140,487,9013.06,2029-11-25,55819.25
3141,487,16144.62,2030-01-01,39674.63
3142,487,6098.84,2030-07-23,33575.79
3143,487,5670.71,2032-01-17,27905.08
3144,487,5573.78,2032-03-29,22331.3
3145,488,38356.18,2024-07-08,231863.01
3146,488,44607.95,2024-12-06,187255.06
3147,488,47290.04,2025-09-07,139965.02
3148,489,52407.49,2024-07-24,313714.17
3149,489,39785.08,2024-08-18,273929.09
3150,489,57024.98,2024-11-22,216904.11
3151,489,44062.45,2024-12-12,172841.66
3152,489,51130.18,2024-12-28,121711.48
3153,489,32987.24,2025-04-19,88724.24
3154,489,16346.14,2025-06-14,72378.1
3155,489,4891.05,2025-07-15,67487.05
3156,490,4810.11,2024-12-29,27437.59
3157,490,2397.4,2025-03-23,25040.19
3158,490,3938.58,2025-06-07,21101.61
3159,490,4611.33,2026-03-19,16490.28
3160,491,20422.75,2024-01-14,189615.66
3161,491,35961.69,2024-01-29,153653.97
3162,491,23957.08,2024-12-15,129696.89
3163,491,22764.24,2025-01-11,106932.65
3164,491,9238.66,2025-03-13,97693.99
3165,491,12207.86,2026-02-23,85486.13
3166,491,16403.49,2027-03-12,69082.64
3167,491,3638.29,2027-04-26,65444.35
3168,491,9665.43,2027-08-10,55778.92
3169,491,8445.53,2027-09-20,47333.39
3170,492,27988.07,2024-12-05,134545.89
3171,492,28543.98,2025-03-07,106001.91
3172,492,13725.02,2025-04-19,92276.89
3173,492,12182.98,2025-11-14,80093.91
3174,492,18924.15,2026-01-18,61169.76
3175,492,4829.25,2026-04-23,56340.51
3176,492,11383.73,2026-11-04,44956.78
3177,492,9938.63,2027-04-01,35018.15
3178,492,8549.88,2027-07-16,26468.27
3179,493,19343.48,2021-11-11,52195.72
3180,493,8571.32,2022-11-04,43624.4
3181,493,11951.68,2023-11-05,31672.72
3182,493,2125.19,2024-04-07,29547.53
3183,493,6233.22,2025-09-06,23314.31
3184,493,5000.46,2027-07-07,18313.85
3185,494,60531.78,2024-10-22,371221.91
3186,494,57620.48,2025-03-07,313601.43
3187,494,88398.46,2025-07-09,225202.97
3188,495,59531.49,2021-05-08,224376.55
3189,495,35929.56,2023-10-02,188446.99
3190,495,24578.84,2024-10-19,163868.15
3191,496,6969.5,2022-11-02,18122.67
3192,496,3543.09,2023-02-15,14579.58
3193,496,3058.07,2023-08-02,11521.51
3194,496,1584.02,2025-03-20,9937.49
3195,496,675.35,2025-12-26,9262.14
3196,496,2211.47,2026-08-11,7050.67
3197,496,404.99,2027-05-20,6645.68
3198,496,721.98,2027-08-25,5923.7
3199,497,56747.21,2023-01-25,162572.17
3200,497,12387.89,2023-05-14,150184.28
3201,497,14983.62,2023-06-09,135200.66
3202,497,15791.04,2023-08-27,119409.62
3203,497,22932.19,2023-11-19,96477.43
3204,497,23022.53,2024-02-13,73454.9
3205,497,17692.6,2024-10-15,55762.3
3206,498,38260.71,2023-07-28,192644.92
3207,498,42344.39,2023-08-09,150300.53
3208,498,18713.73,2024-05-15,131586.8
3209,498,31605.01,2024-10-11,99981.79
3210,498,17254.91,2026-04-27,82726.88
3211,498,11639.86,2027-10-29,71087.02
3212,498,3957.51,2028-10-08,67129.51
3213,498,5971.32,2030-07-05,61158.19
3214,499,105461.56,2023-08-26,370786.52
3215,499,82540.75,2023-11-05,288245.77
3216,499,18474.4,2023-12-06,269771.37
3217,499,76629.02,2024-07-26,193142.35
3218,499,43455.54,2024-11-10,149686.81
3219,499,13434.1,2024-12-24,136252.71
3220,499,35544.36,2025-01-31,100708.35
3221,500,50045.69,2025-12-11,354424.43
3222,500,27940.96,2026-04-21,326483.47
3223,500,86930.34,2026-11-24,239553.13
3224,500,40364.68,2027-04-10,199188.45
3225,500,53378.54,2027-08-30,145809.91
3226,500,42276.7,2028-11-12,103533.21
3227,500,12290.92,2029-12-03,91242.29
3228,501,1292.77,2025-08-13,11132.37
3229,501,1894.24,2026-01-15,9238.13
3230,501,1205.4,2026-03-26,8032.73
3231,501,1341.79,2027-03-18,6690.94
3232,501,1875.3,2027-06-12,4815.64
3233,501,698.82,2027-10-13,4116.82
3234,501,699.1,2028-06-01,3417.72
3235,501,778.54,2029-05-30,2639.18
3236,501,615.95,2030-02-06,2023.23
3237,502,39749.35,2022-05-25,95959.85
3238,502,6292.83,2023-04-13,89667.02
3239,502,13229.76,2023-10-29,76437.26
3240,502,15816.49,2024-09-06,60620.77
3241,502,5288.71,2025-01-16,55332.06
3242,502,7785.79,2025-11-30,47546.27
3243,502,12661.05,2025-12-10,34885.22
3244,502,3662.03,2026-09-07,31223.19
3245,503,95210.88,2026-07-05,262547.56
3246,503,20139.81,2026-08-15,242407.75
3247,503,42198.08,2026-08-24,200209.67
3248,503,45939.03,2026-10-15,154270.64
3249,503,45677.36,2027-01-08,108593.28
3250,503,15620.43,2027-01-20,92972.85
3251,503,6102.97,2027-02-01,86869.88
3252,503,11413.73,2028-07-02,75456.15
3253,503,6953.37,2028-09-02,68502.78
3254,503,14424.14,2028-09-24,54078.64
3255,504,117349.35,2022-06-27,304297.51
3256,504,62308.2,2022-11-16,241989.31
3257,504,68917.02,2023-01-22,173072.29
3258,504,46982.72,2025-04-03,126089.57
3259,504,13973.38,2025-12-09,112116.19
3260,504,6495.12,2027-09-18,105621.07
3261,504,11791.27,2028-10-28,93829.8
3262,505,9282.89,2024-03-19,63640.44
3263,505,6152.43,2025-11-25,57488.01
3264,505,8460.71,2025-12-08,49027.3
3265,506,39438.01,2022-05-10,239252.83
3266,506,16116.18,2022-06-13,223136.65
3267,506,16060.21,2023-08-25,207076.44
3268,506,60390.45,2023-10-31,146685.99
3269,506,10965.94,2024-05-07,135720.05
3270,506,20221.53,2024-06-19,115498.52
3271,506,23990.02,2024-10-24,91508.5
3272,507,123382.76,2025-10-01,335988.78
3273,507,51923.59,2027-04-28,284065.19
3274,507,76042.87,2028-08-31,208022.32
3275,507,44943.78,2029-05-20,163078.54
3276,507,43149.58,2031-10-07,119928.96
3277,507,19215.83,2032-06-17,100713.13
3278,508,31889.79,2021-07-22,100262.66
3279,508,27160.17,2022-11-17,73102.49
3280,508,18192.02,2023-03-26,54910.47
3281,508,8964.74,2023-04-07,45945.73
3282,508,6460.6,2024-11-01,39485.13
3283,508,11387.11,2025-07-03,28098.02
3284,508,4854.81,2025-09-18,23243.21
3285,508,1953.4,2027-11-27,21289.81
3286,509,58328.77,2024-03-27,278628.08
3287,509,56044.85,2025-04-30,222583.23
3288,509,30903.7,2026-04-15,191679.53
3289,509,35881.03,2027-12-17,155798.5
3290,509,34827.53,2028-05-11,120970.97
3291,509,29924.41,2031-04-30,91046.56
3292,510,43903.1,2021-03-07,199250.42
3293,510,43407.17,2021-08-31,155843.25
3294,510,32554.46,2024-11-02,123288.79
3295,511,20873.69,2025-04-11,201064.19
3296,511,41154.11,2025-12-04,159910.08
3297,511,32046.66,2026-11-06,127863.42
3298,511,6956.62,2030-11-04,120906.8
3299,511,7833.04,2034-09-12,113073.76
3300,511,13626.28,2034-09-15,99447.48
3301,512,61745.41,2026-02-17,328941.38
3302,512,32527.36,2028-10-19,296414.02
3303,512,15960.67,2031-02-18,280453.35
3304,512,41423.67,2031-07-09,239029.68
3305,512,13606.99,2033-10-08,225422.69
3306,512,17950.86,2033-10-18,207471.83
3307,513,66778.95,2026-07-05,405046.55
3308,513,35603.65,2029-03-07,369442.9
3309,513,100423.68,2032-01-14,269019.22
3310,513,63699.82,2032-05-27,205319.4
3311,513,28285.61,2033-03-16,177033.79
3312,513,25613.8,2033-04-09,151419.99
3313,514,107385.43,2021-01-29,313235.93
3314,514,86868.69,2021-02-25,226367.24
3315,514,51726.78,2021-08-17,174640.46
3316,514,45176.46,2021-09-30,129464.0
3317,514,28553.24,2022-04-23,100910.76
3318,514,17769.71,2022-06-16,83141.05
3319,514,8214.57,2022-08-30,74926.48
3320,514,22147.5,2022-10-22,52778.98
3321,515,67426.83,2022-06-18,423792.49
3322,515,111059.2,2024-08-05,312733.29
3323,515,70734.46,2025-09-11,241998.83
3324,515,33957.84,2026-05-28,208040.99
3325,516,34513.15,2024-11-19,180100.17
3326,516,45144.82,2025-03-24,134955.35
3327,516,10309.85,2025-12-05,124645.5
3328,516,21180.22,2026-04-10,103465.28
3329,516,18162.73,2026-08-14,85302.55
3330,516,21487.9,2027-04-25,63814.65
3331,516,10249.19,2027-06-23,53565.46
3332,517,84218.17,2026-11-12,210870.32
3333,517,26125.83,2027-09-14,184744.49
3334,517,37430.38,2029-01-12,147314.11
3335,518,26716.1,2026-08-05,258223.81
3336,518,37197.96,2027-08-29,221025.85
3337,518,38565.24,2028-04-11,182460.61
3338,518,10968.43,2029-10-13,171492.18
3339,518,17310.52,2030-08-06,154181.66
3340,518,14283.8,2032-11-04,139897.86
3341,519,3347.22,2026-01-29,25234.58
3342,519,2234.42,2026-07-12,23000.16
3343,519,4039.0,2027-01-08,18961.16
3344,519,2308.94,2028-07-19,16652.22
3345,519,3733.59,2029-03-13,12918.63
3346,519,757.36,2029-06-13,12161.27
3347,519,2925.14,2030-05-10,9236.13
3348,519,835.45,2030-10-30,8400.68
3349,519,1133.04,2032-03-16,7267.64
3350,520,22377.73,2027-09-30,79748.13
3351,520,19727.82,2028-04-05,60020.31
3352,520,15823.55,2029-03-18,44196.76
3353,521,20446.31,2021-07-11,72654.03
3354,521,9100.31,2021-09-01,63553.72
3355,521,9649.27,2021-09-26,53904.45
3356,521,4539.19,2021-10-13,49365.26
3357,521,6619.55,2022-01-19,42745.71
3358,522,3849.45,2023-11-18,21009.65
3359,522,2587.14,2024-02-18,18422.51
3360,522,2951.28,2030-01-19,15471.23
3361,523,24506.83,2021-11-12,184229.36
3362,523,54762.51,2021-12-14,129466.85
3363,523,17300.89,2022-03-11,112165.96
3364,523,19280.1,2022-07-22,92885.86
3365,523,13268.7,2022-09-05,79617.16
3366,524,77986.74,2024-07-14,207602.9
3367,524,37144.14,2025-03-18,170458.76
3368,524,23264.32,2026-01-12,147194.44
3369,524,27955.54,2026-03-06,119238.9
3370,524,20018.26,2026-10-24,99220.64
3371,524,27297.46,2029-06-18,71923.18
3372,525,3498.9,2023-05-28,23100.44
3373,525,6328.83,2023-07-05,16771.61
3374,525,2457.32,2023-07-28,14314.29
3375,525,943.44,2024-09-02,13370.85
3376,526,41554.33,2026-03-11,128406.33
3377,526,30282.53,2026-08-14,98123.8
3378,526,19426.81,2027-03-13,78696.99
3379,526,13340.94,2027-03-26,65356.05
3380,526,19142.22,2027-08-14,46213.83
3381,526,10109.59,2028-03-25,36104.24
3382,527,100210.39,2023-08-24,391536.67
3383,527,115046.5,2023-11-10,276490.17
3384,527,69481.64,2024-03-31,207008.53
3385,528,45797.79,2026-03-08,147990.57
3386,528,39874.79,2026-06-28,108115.78
3387,528,32214.65,2028-10-24,75901.13
3388,529,32866.92,2024-03-07,87842.77
3389,529,21058.22,2027-06-03,66784.55
3390,529,9620.62,2032-05-10,57163.93
3391,529,13012.11,2033-02-13,44151.82
3392,530,41395.55,2023-10-29,121514.62
3393,530,19768.36,2023-11-14,101746.26
3394,530,15551.93,2024-01-21,86194.33
3395,530,8541.51,2024-05-31,77652.82
3396,530,14156.05,2025-04-28,63496.77
3397,530,13238.99,2025-06-07,50257.78
3398,530,6712.29,2025-06-11,43545.49
3399,530,7784.35,2027-01-28,35761.14
3400,530,2915.48,2027-12-12,32845.66
3401,531,79038.27,2024-01-08,211004.63
3402,531,36683.04,2025-03-17,174321.59
3403,531,41040.18,2026-04-11,133281.41
3404,531,10161.12,2026-08-22,123120.29
3405,531,23286.44,2026-09-10,99833.85
3406,531,8107.65,2026-11-04,91726.2
3407,531,25525.13,2027-11-28,66201.07
3408,532,72899.98,2024-02-12,383976.07
3409,532,70130.72,2029-10-13,313845.35
3410,532,67987.86,2031-03-29,245857.49
3411,532,24223.17,2031-04-29,221634.32
3412,532,19432.62,2032-01-29,202201.7
3413,533,53728.21,2022-10-17,230899.05
3414,533,44648.98,2022-11-25,186250.07
3415,533,52118.18,2022-11-27,134131.89
3416,533,25743.99,2023-10-13,108387.9
3417,533,16511.87,2024-12-17,91876.03
3418,533,16610.53,2025-03-24,75265.5
3419,533,5333.73,2025-05-13,69931.77
3420,533,13892.26,2025-12-01,56039.51
3421,534,6792.87,2023-10-26,77777.26
3422,534,15995.83,2023-12-01,61781.43
3423,534,12603.24,2023-12-13,49178.19
3424,534,5224.3,2025-03-31,43953.89
3425,535,47976.85,2022-01-04,192872.01
3426,535,24154.06,2022-02-20,168717.95
3427,535,21652.24,2023-01-03,147065.71
3428,535,38597.99,2023-04-20,108467.72
3429,535,17287.63,2023-11-25,91180.09
3430,535,19815.95,2024-07-12,71364.14
3431,535,16314.38,2024-09-03,55049.76
3432,535,10937.44,2025-02-24,44112.32
3433,535,7215.65,2025-05-09,36896.67
3434,535,1975.03,2026-05-13,34921.64
3435,536,22773.76,2021-05-05,131662.01
3436,536,24049.59,2021-08-06,107612.42
3437,536,13218.47,2022-05-17,94393.95
3438,536,24677.11,2023-07-04,69716.84
3439,537,41381.11,2021-07-13,151489.92
3440,537,29430.82,2021-08-05,122059.1
3441,537,16518.76,2022-01-03,105540.34
3442,537,13509.79,2022-03-02,92030.55
3443,537,20990.27,2022-04-09,71040.28
3444,537,16297.41,2022-06-23,54742.87
3445,537,3599.28,2022-09-26,51143.59
3446,537,3507.29,2022-11-01,47636.3
3447,537,3795.44,2023-01-05,43840.86
3448,537,7593.79,2023-01-12,36247.07
3449,538,41032.3,2022-02-09,199587.84
3450,538,30023.32,2022-03-02,169564.52
3451,538,45792.85,2022-10-31,123771.67
3452,538,33355.34,2023-08-21,90416.33
3453,538,25770.79,2024-03-11,64645.54
3454,538,3839.65,2024-04-06,60805.89
3455,539,70695.34,2024-10-21,172022.43
3456,539,22074.61,2024-12-13,149947.82
3457,539,29482.98,2025-06-03,120464.84
3458,539,21256.21,2025-06-17,99208.63
3459,539,23449.95,2026-02-06,75758.68
3460,539,22664.67,2026-02-09,53094.01
3461,539,6144.08,2026-02-25,46949.93
3462,539,3202.95,2026-02-27,43746.98
3463,539,10679.47,2026-03-08,33067.51
3464,539,5046.47,2026-08-13,28021.04
3465,540,42212.36,2022-10-09,173093.75
3466,540,32942.31,2022-10-16,140151.44
3467,540,8978.06,2023-09-27,131173.38
3468,540,33681.93,2024-07-24,97491.45
3469,540,20607.81,2027-07-06,76883.64
3470,541,34229.24,2025-07-29,317558.32
3471,541,25605.58,2025-12-26,291952.74
3472,541,15846.57,2026-05-19,276106.17
3473,541,44910.79,2026-10-27,231195.38
3474,541,13373.91,2028-09-06,217821.47
3475,541,26980.64,2029-04-01,190840.83
3476,541,26223.06,2030-02-26,164617.77
3477,541,15746.13,2030-08-23,148871.64
3478,541,30800.7,2031-03-10,118070.94
3479,541,23920.18,2031-11-21,94150.76
3480,542,106815.22,2024-04-26,280154.14
3481,542,29004.41,2024-08-01,251149.73
3482,542,21356.27,2024-10-03,229793.46
3483,542,47375.58,2024-11-12,182417.88
3484,542,33999.32,2026-05-22,148418.56
3485,542,30031.07,2026-07-10,118387.49
3486,542,29815.43,2026-08-10,88572.06
3487,542,8984.96,2027-01-28,79587.1
3488,542,9160.44,2027-10-06,70426.66
3489,542,17151.03,2028-05-18,53275.63
3490,543,64544.13,2023-02-22,274924.66
3491,543,68533.53,2024-02-29,206391.13
3492,543,13039.86,2024-09-07,193351.27
3493,543,51676.57,2024-11-02,141674.7
3494,543,25543.42,2025-03-05,116131.28
3495,544,22939.02,2021-11-13,321614.68
3496,544,71611.16,2022-02-22,250003.52
3497,544,59215.5,2022-03-03,190788.02
3498,544,46738.0,2023-06-07,144050.02
3499,544,28671.22,2023-08-05,115378.8
3500,544,17849.32,2024-08-25,97529.48
3501,544,6773.05,2025-05-06,90756.43
3502,545,123113.51,2021-11-06,306976.71
3503,545,67050.68,2022-07-12,239926.03
3504,545,56891.94,2023-12-18,183034.09
3505,545,30544.92,2024-03-12,152489.17
3506,546,32073.27,2023-01-21,454866.13
3507,546,92322.59,2029-03-31,362543.54
3508,546,72670.31,2029-07-23,289873.23
3509,546,83857.39,2030-07-23,206015.84
3510,546,15917.67,2030-10-29,190098.17
3511,547,15689.45,2023-12-24,74144.03
3512,547,7797.13,2024-02-27,66346.9
3513,547,18550.78,2025-02-12,47796.12
3514,547,12881.68,2025-03-14,34914.44
3515,547,4945.92,2026-03-16,29968.52
3516,547,3189.24,2026-03-23,26779.28
3517,547,7035.41,2026-06-03,19743.87
3518,547,2023.97,2026-06-09,17719.9
3519,547,1483.22,2026-11-29,16236.68
3520,547,4449.28,2027-09-23,11787.4
3521,548,25527.99,2021-06-01,193179.06
3522,548,55476.08,2023-03-05,137702.98
3523,548,22751.98,2023-09-27,114951.0
3524,548,32924.65,2024-12-01,82026.35
3525,548,20956.6,2024-12-19,61069.75
3526,548,18032.95,2026-08-05,43036.8
3527,548,11043.71,2028-01-08,31993.09
3528,549,2282.3,2025-03-26,31285.61
3529,549,9015.78,2025-04-10,22269.83
3530,549,5666.66,2025-06-18,16603.17
3531,549,2481.71,2025-11-21,14121.46
3532,549,3066.25,2026-10-23,11055.21
3533,549,928.84,2027-01-01,10126.37
3534,549,1359.83,2028-03-25,8766.54
3535,549,828.31,2028-11-02,7938.23
3536,550,20174.4,2026-07-31,293209.55
3537,550,63304.97,2026-12-15,229904.58
3538,550,62922.83,2027-05-01,166981.75
3539,551,19167.91,2024-02-23,129632.8
3540,551,18370.3,2024-04-06,111262.5
3541,551,23443.74,2024-08-17,87818.76
3542,551,6080.73,2026-01-23,81738.03
3543,551,4918.56,2026-06-02,76819.47
3544,551,15187.98,2026-07-22,61631.49
3545,551,6316.27,2026-10-26,55315.22
3546,551,14523.4,2028-04-01,40791.82
3547,551,5614.94,2028-04-05,35176.88
3548,552,28215.12,2022-07-13,179460.09
3549,552,27679.59,2022-08-10,151780.5
3550,552,29287.03,2022-09-04,122493.47
3551,552,35175.81,2023-04-16,87317.66
3552,552,21113.97,2023-06-16,66203.69
3553,552,19779.05,2023-08-08,46424.64
3554,552,12323.69,2023-09-14,34100.95
3555,552,7430.88,2024-11-27,26670.07
3556,553,55876.97,2024-01-29,193771.23
3557,553,15584.75,2024-03-17,178186.48
3558,553,48230.17,2025-03-27,129956.31
3559,553,16435.01,2025-06-20,113521.3
3560,553,20435.4,2025-10-08,93085.9
3561,554,6755.48,2023-02-13,114519.75
3562,554,9989.32,2023-03-25,104530.43
3563,554,15921.98,2025-06-18,88608.45
3564,554,4539.31,2025-06-18,84069.14
3565,554,19263.68,2026-05-11,64805.46
3566,554,19244.93,2026-08-10,45560.53
3567,554,9674.38,2027-06-01,35886.15
3568,554,2237.23,2027-08-19,33648.92
3569,554,6682.65,2028-05-20,26966.27
3570,555,12868.49,2023-11-01,112346.82
3571,555,9804.21,2023-11-11,102542.61
3572,555,29892.83,2024-04-20,72649.78
3573,555,11923.08,2025-08-22,60726.7
3574,555,6441.91,2025-10-20,54284.79
3575,555,14193.53,2026-05-22,40091.26
3576,555,4778.65,2026-08-13,35312.61
3577,555,5758.4,2026-12-12,29554.21
3578,555,2367.11,2028-01-14,27187.1
3579,555,6747.31,2028-03-26,20439.79
3580,556,61180.42,2022-03-21,194866.49
3581,556,37174.78,2022-06-17,157691.71
3582,556,11251.61,2022-07-25,146440.1
3583,556,35813.36,2022-10-23,110626.74
3584,556,20548.91,2023-01-12,90077.83
3585,556,14086.32,2023-01-29,75991.51
3586,557,16458.41,2022-07-10,258395.13
3587,557,25469.69,2022-09-02,232925.44
3588,557,29797.5,2022-09-25,203127.94
3589,557,46725.82,2025-01-29,156402.12
3590,557,30209.07,2025-04-02,126193.05
3591,558,28475.21,2024-12-21,178177.61
3592,558,14344.2,2025-10-18,163833.41
3593,558,11260.8,2025-12-09,152572.61
3594,558,45716.7,2026-05-12,106855.91
3595,558,30514.0,2026-07-22,76341.91
3596,558,21373.95,2026-09-06,54967.96
3597,558,16063.07,2027-03-19,38904.89
3598,558,7080.08,2027-10-30,31824.81
3599,558,8004.34,2027-11-19,23820.47
3600,559,55254.64,2020-09-15,183063.39
3601,559,40806.3,2020-10-08,142257.09
3602,559,32708.94,2020-10-15,109548.15
3603,559,8901.5,2020-11-08,100646.65
3604,559,28341.48,2021-07-14,72305.17
3605,560,9604.56,2022-04-11,50395.32
3606,560,9667.55,2023-04-12,40727.77
3607,560,11536.91,2024-07-25,29190.86
3608,560,5369.14,2026-01-22,23821.72
3609,560,6734.8,2028-06-17,17086.92
3610,560,1120.15,2029-02-08,15966.77
3611,561,105976.89,2021-07-03,339241.16
3612,561,86299.82,2022-10-18,252941.34
3613,561,36413.14,2023-12-04,216528.2
3614,561,47466.71,2024-04-08,169061.49
3615,561,27666.55,2025-05-04,141394.94
3616,562,11288.15,2024-01-06,120574.64
3617,562,14839.94,2026-06-05,105734.7
3618,562,19760.06,2027-05-07,85974.64
3619,562,10389.65,2030-07-01,75584.99
3620,562,11175.24,2030-10-09,64409.75
3621,563,63715.61,2023-11-09,205446.06
3622,563,55414.01,2024-01-03,150032.05
3623,563,24271.14,2024-02-24,125760.91
3624,563,9493.98,2024-03-12,116266.93
3625,563,7398.91,2024-04-06,108868.02
3626,563,10617.62,2024-06-26,98250.4
3627,563,10003.39,2024-06-30,88247.01
3628,564,24758.64,2024-08-30,61284.44
3629,564,16500.14,2025-10-04,44784.3
3630,564,10487.55,2025-10-12,34296.75
3631,564,5165.96,2025-11-01,29130.79
3632,564,7710.79,2026-01-05,21420.0
3633,564,1912.13,2026-02-18,19507.87
3634,564,1018.22,2026-02-27,18489.65
3635,564,4208.68,2026-05-11,14280.97
3636,564,1881.54,2026-05-16,12399.43
3637,565,21410.86,2022-04-05,127472.91
3638,565,29872.41,2022-07-30,97600.5
3639,565,29057.91,2022-10-04,68542.59
3640,565,7754.8,2023-09-08,60787.79
3641,565,6887.05,2025-03-04,53900.74
3642,566,3679.85,2022-04-01,62449.24
3643,566,5842.4,2022-07-10,56606.84
3644,566,12971.35,2022-12-04,43635.49
3645,566,3278.67,2023-05-06,40356.82
3646,566,3085.17,2023-08-09,37271.65
3647,566,7585.67,2024-10-10,29685.98
3648,566,6599.2,2024-12-18,23086.78
3649,566,5259.68,2024-12-27,17827.1
3650,566,2096.7,2025-08-13,15730.4
3651,566,4256.43,2026-03-12,11473.97
3652,567,21939.41,2022-05-14,52294.8
3653,567,6074.43,2022-08-25,46220.37
3654,567,8674.2,2024-01-14,37546.17
3655,567,6564.04,2026-02-09,30982.13
3656,567,7758.44,2026-02-20,23223.69
3657,568,63576.29,2025-07-05,152431.79
3658,568,40021.17,2027-04-03,112410.62
3659,568,25594.93,2029-06-15,86815.69
3660,568,4563.75,2030-03-31,82251.94
3661,568,9216.03,2032-05-22,73035.91
3662,568,15016.93,2032-06-04,58018.98
3663,569,83049.82,2020-07-04,201079.35
3664,569,52943.65,2020-09-29,148135.7
3665,569,38311.64,2021-01-11,109824.06
3666,569,31418.65,2021-07-29,78405.41
3667,569,8618.43,2022-02-06,69786.98
3668,569,16183.48,2022-03-22,53603.5
3669,569,8564.13,2022-06-09,45039.37
3670,570,52476.16,2027-03-18,163279.96
3671,570,40963.25,2027-08-30,122316.71
3672,570,33239.74,2033-01-12,89076.97
3673,570,19477.02,2033-03-22,69599.95
3674,570,4363.75,2034-04-20,65236.2
3675,570,16811.53,2034-04-21,48424.67
3676,571,95696.84,2022-02-06,291469.12
3677,571,51966.63,2022-06-19,239502.49
3678,571,15805.39,2022-06-26,223697.1
3679,571,24381.17,2022-07-02,199315.93
3680,571,46399.89,2022-08-20,152916.04
3681,571,31065.64,2022-09-23,121850.4
3682,571,28483.06,2022-10-15,93367.34
3683,571,11182.8,2022-11-28,82184.54
3684,571,14523.86,2022-12-04,67660.68
3685,572,41324.2,2026-08-18,260030.41
3686,572,44679.72,2029-04-04,215350.69
3687,572,43357.52,2029-09-25,171993.17
3688,572,33342.3,2029-11-13,138650.87
3689,572,40073.86,2029-12-13,98577.01
3690,572,14242.87,2031-04-13,84334.14
3691,572,5689.01,2031-05-25,78645.13
3692,572,14321.69,2032-05-11,64323.44
3693,572,16120.13,2033-01-22,48203.31
3694,573,17876.3,2021-07-08,43584.81
3695,573,5102.11,2023-02-25,38482.7
3696,573,3385.24,2027-06-25,35097.46
3697,573,9257.49,2027-08-31,25839.97
3698,574,50472.29,2026-10-10,180944.52
3699,574,43499.19,2027-07-05,137445.33
3700,574,29584.88,2028-03-09,107860.45
3701,575,55967.85,2022-05-09,254719.24
3702,575,16177.53,2023-04-06,238541.71
3703,575,38142.04,2024-07-15,200399.67
3704,575,48401.33,2024-08-21,151998.34
3705,575,17888.31,2025-08-03,134110.03
3706,575,8457.33,2025-10-15,125652.7
3707,576,39350.13,2021-03-20,363291.9
3708,576,79973.33,2021-06-10,283318.57
3709,576,84270.77,2021-10-24,199047.8
3710,576,26625.33,2022-09-07,172422.47
3711,576,31621.5,2024-07-25,140800.97
3712,576,23147.84,2025-04-03,117653.13
3713,576,22691.88,2027-01-18,94961.25
3714,576,25481.35,2027-02-27,69479.9
3715,576,4634.92,2027-06-06,64844.98
3716,577,4409.55,2024-10-18,61959.05
3717,577,5493.46,2025-01-16,56465.59
3718,577,4823.68,2025-07-17,51641.91
3719,577,14809.98,2031-10-05,36831.93
3720,578,117667.55,2023-10-31,366320.4
3721,578,36431.56,2025-05-04,329888.84
3722,578,92218.8,2028-04-25,237670.04
3723,579,60910.37,2023-07-09,202736.34
3724,579,40591.06,2025-09-14,162145.28
3725,579,19167.13,2028-01-20,142978.15
3726,579,17108.96,2028-04-14,125869.19
3727,579,37036.27,2028-07-22,88832.92
3728,580,27013.48,2024-11-22,407421.98
3729,580,119329.27,2026-04-03,288092.71
3730,580,50885.31,2026-06-07,237207.4
3731,580,29692.53,2026-08-05,207514.87
3732,580,19578.38,2026-11-10,187936.49
3733,580,29521.76,2027-03-27,158414.73
3734,580,44764.08,2027-05-04,113650.65
3735,580,25507.96,2027-11-14,88142.69
3736,581,17597.01,2025-03-18,197924.51
3737,581,32398.59,2025-05-18,165525.92
3738,581,35375.03,2025-11-28,130150.89
3739,581,15982.83,2026-03-20,114168.06
3740,581,18241.27,2026-04-16,95926.79
3741,581,22722.92,2027-01-25,73203.87
3742,581,6869.29,2027-07-18,66334.58
3743,581,12323.42,2027-12-31,54011.16
3744,582,27844.69,2025-04-08,275272.62
3745,582,34026.93,2025-08-10,241245.69
3746,582,65865.27,2026-02-17,175380.42
3747,582,11433.65,2026-02-25,163946.77
3748,582,45976.57,2026-10-16,117970.2
3749,582,30279.75,2027-01-18,87690.45
3750,582,18692.02,2027-06-30,68998.43
3751,582,14010.51,2027-11-16,54987.92
3752,582,7076.1,2028-01-22,47911.82
3753,583,45803.08,2025-11-16,129394.18
3754,583,26486.16,2026-03-14,102908.02
3755,583,25707.23,2029-07-22,77200.79
3756,584,40911.12,2023-11-17,268194.65
3757,584,41813.4,2024-08-02,226381.25
3758,584,57188.15,2025-04-08,169193.1
3759,584,18354.28,2025-04-15,150838.82
3760,584,29466.5,2025-11-25,121372.32
3761,584,26978.79,2026-08-27,94393.53
3762,584,6197.22,2026-09-04,88196.31
3763,584,4783.15,2027-04-01,83413.16
3764,584,14131.93,2027-11-23,69281.23
3765,585,46894.63,2023-07-28,122832.34
3766,585,22443.95,2024-12-17,100388.39
3767,585,29840.58,2025-03-17,70547.81
3768,585,21098.54,2026-06-17,49449.27
3769,585,7590.12,2027-10-19,41859.15
3770,585,5149.7,2028-07-23,36709.45
3771,585,2658.49,2030-06-15,34050.96
3772,585,7868.0,2030-11-17,26182.96
3773,586,43474.73,2024-01-17,315609.36
3774,586,91958.79,2025-03-15,223650.57
3775,586,48870.76,2025-05-23,174779.81
3776,586,26149.18,2027-07-01,148630.63
3777,587,73715.66,2024-11-09,175775.38
3778,587,52306.77,2025-07-28,123468.61
3779,587,27196.13,2025-08-23,96272.48
3780,587,13844.04,2025-10-16,82428.44
3781,587,20196.8,2026-05-28,62231.64
3782,587,14108.81,2026-06-29,48122.83
3783,587,4352.88,2026-08-28,43769.95
3784,588,10817.97,2022-08-20,54075.21
3785,588,6549.0,2022-10-28,47526.21
3786,588,3078.52,2023-03-31,44447.69
3787,588,10158.88,2024-08-09,34288.81
3788,588,8783.16,2024-11-06,25505.65
3789,588,5403.28,2026-09-01,20102.37
3790,588,5824.54,2026-10-29,14277.83
3791,588,3301.67,2027-10-11,10976.16
3792,588,606.53,2028-02-02,10369.63
3793,588,1983.88,2029-05-09,8385.75
3794,589,12827.35,2025-05-08,33110.89
3795,589,8676.51,2025-05-24,24434.38
3796,589,7033.37,2025-06-28,17401.01
3797,589,2870.89,2026-10-31,14530.12
3798,589,3713.18,2027-12-30,10816.94
3799,590,49599.19,2025-07-22,432892.98
3800,590,119407.23,2025-08-23,313485.75
3801,590,73196.2,2025-12-15,240289.55
3802,590,57728.83,2027-05-22,182560.72
3803,590,23922.71,2028-07-16,158638.01
3804,590,45391.44,2029-06-12,113246.57
3805,590,8944.25,2030-04-09,104302.32
3806,591,101285.18,2024-01-28,352877.85
3807,591,89602.68,2024-08-12,263275.17
3808,591,57731.95,2025-02-13,205543.22
3809,591,12703.86,2025-05-20,192839.36
3810,591,25299.42,2025-09-07,167539.94
3811,591,34011.11,2025-12-09,133528.83
3812,591,21864.0,2026-06-03,111664.83
3813,591,14742.46,2027-10-24,96922.37
3814,591,20877.1,2028-11-11,76045.27
3815,591,12738.51,2029-01-18,63306.76
3816,592,35343.15,2026-01-08,92022.92
3817,592,27355.25,2026-10-27,64667.67
3818,592,9539.8,2028-09-12,55127.87
3819,592,14339.37,2029-09-27,40788.5
3820,592,7571.74,2031-08-27,33216.76
3821,592,5395.14,2033-02-04,27821.62
3822,593,32693.93,2021-08-11,179773.45
3823,593,10058.45,2022-07-17,169715.0
3824,593,10860.24,2022-12-06,158854.76
3825,593,37712.28,2023-03-17,121142.48
3826,593,18187.04,2023-04-20,102955.44
3827,594,28999.27,2026-07-18,442421.07
3828,594,100042.92,2026-09-25,342378.15
3829,594,32024.19,2029-02-04,310353.96
3830,594,19572.74,2029-05-01,290781.22
3831,595,30436.54,2021-12-04,231019.03
3832,595,21619.28,2022-02-28,209399.75
3833,595,55794.89,2024-03-04,153604.86
3834,595,15942.23,2024-03-14,137662.63
3835,596,34067.56,2024-08-28,83509.89
3836,596,14511.61,2024-09-14,68998.28
3837,596,7928.94,2026-08-12,61069.34
3838,596,14078.44,2029-07-21,46990.9
3839,596,13473.05,2030-04-03,33517.85
3840,596,5265.68,2032-11-17,28252.17
3841,596,2218.31,2033-03-25,26033.86
3842,597,15755.11,2026-01-03,95044.01
3843,597,23995.89,2030-03-23,71048.12
3844,597,19330.38,2030-10-29,51717.74
3845,597,12654.48,2030-12-06,39063.26
3846,598,65312.67,2023-04-15,391610.61
3847,598,21917.91,2023-10-08,369692.7
3848,598,71179.51,2023-10-26,298513.19
3849,598,54683.06,2023-11-03,243830.13
3850,599,17146.46,2020-11-11,142347.4
3851,599,21011.55,2021-01-23,121335.85
3852,599,13151.82,2021-04-05,108184.03
3853,599,9046.0,2021-06-14,99138.03
3854,599,5934.53,2021-10-01,93203.5
3855,599,25093.45,2021-11-28,68110.05
3856,600,28939.75,2022-10-18,143400.33
3857,600,37064.31,2022-11-11,106336.02
3858,600,11574.55,2023-01-05,94761.47
3859,600,13889.21,2023-04-13,80872.26
3860,600,5398.61,2023-04-18,75473.65
3861,600,14876.19,2023-06-11,60597.46
3862,600,6964.4,2023-06-26,53633.06
3863,600,4192.54,2023-07-10,49440.52
3864,600,13081.16,2023-07-15,36359.36
3865,600,5896.72,2023-08-13,30462.64
3866,601,9356.48,2022-03-29,48641.87
3867,601,13029.97,2023-03-18,35611.9
3868,601,6051.57,2024-08-22,29560.33
3869,601,2127.72,2025-01-30,27432.61
3870,601,5113.68,2025-10-30,22318.93
3871,601,5019.03,2026-12-23,17299.9
3872,601,2811.83,2027-01-30,14488.07
3873,601,887.64,2027-08-20,13600.43
3874,601,1449.95,2027-12-28,12150.48
3875,602,14547.99,2023-03-18,143952.57
3876,602,7376.95,2023-05-05,136575.62
3877,602,27077.61,2023-05-17,109498.01
3878,602,5559.28,2023-06-13,103938.73
3879,602,19975.91,2023-11-02,83962.82
3880,602,16692.09,2024-01-22,67270.73
3881,602,10612.5,2024-03-01,56658.23
3882,602,8325.75,2024-07-30,48332.48
3883,603,102324.21,2022-06-01,359968.13
3884,603,107579.19,2022-12-14,252388.94
3885,603,62910.78,2023-08-14,189478.16
3886,604,7304.39,2024-05-01,79623.05
3887,604,10306.22,2024-05-20,69316.83
3888,604,16807.38,2024-06-02,52509.45
3889,604,4254.52,2024-07-12,48254.93
3890,604,11466.03,2024-09-02,36788.9
3891,604,5574.21,2024-10-17,31214.69
3892,604,7429.68,2024-11-14,23785.01
3893,604,4734.73,2025-02-07,19050.28
3894,604,3589.07,2025-02-16,15461.21
3895,604,1031.81,2025-03-08,14429.4
3896,605,9289.72,2023-04-14,168776.37
3897,605,41717.06,2023-04-29,127059.31
3898,605,16926.33,2023-05-14,110132.98
3899,605,30284.86,2023-07-18,79848.12
3900,605,8768.94,2023-09-22,71079.18
3901,605,16737.38,2023-10-31,54341.8
3902,605,10041.16,2024-07-10,44300.64
3903,605,2259.08,2025-02-04,42041.56
3904,605,8039.41,2025-05-22,34002.15
3905,606,2475.15,2021-05-11,13319.57
3906,606,1055.05,2025-08-12,12264.52
3907,606,807.08,2026-08-10,11457.44
3908,607,98991.38,2021-11-02,263565.88
3909,607,64502.59,2021-11-25,199063.29
3910,607,45627.47,2023-06-03,153435.82
3911,607,26875.53,2024-05-29,126560.29
3912,607,24559.52,2025-02-19,102000.77
3913,607,14667.46,2025-04-25,87333.31
3914,607,5515.6,2028-10-09,81817.71
3915,607,20694.65,2029-07-07,61123.06
3916,607,13855.48,2029-12-15,47267.58
3917,608,36313.71,2022-08-23,195537.8
3918,608,54500.7,2022-11-04,141037.1
3919,608,33794.48,2023-09-11,107242.62
3920,609,9315.78,2021-12-12,39340.62
3921,609,5085.44,2022-06-21,34255.18
3922,609,6227.87,2023-07-07,28027.31
3923,609,6950.97,2024-09-02,21076.34
3924,610,34048.29,2025-06-28,394381.51
3925,610,75236.68,2027-04-18,319144.83
3926,610,43012.91,2027-08-10,276131.92
3927,610,34336.0,2028-04-17,241795.92
3928,610,64280.5,2028-08-31,177515.42
3929,610,36590.05,2028-11-21,140925.37
3930,610,30929.66,2029-04-25,109995.71
3931,610,19398.78,2031-01-22,90596.93
3932,610,9489.36,2032-06-09,81107.57
3933,610,10652.85,2032-12-03,70454.72
3934,611,20571.92,2023-02-25,122954.67
3935,611,25835.24,2023-12-18,97119.43
3936,611,26915.41,2024-06-12,70204.02
3937,611,8262.38,2024-08-16,61941.64
3938,611,6376.68,2024-09-29,55564.96
3939,612,35391.08,2023-08-08,277394.8
3940,612,68841.98,2025-11-23,208552.82
3941,612,32364.51,2026-01-27,176188.31
3942,612,14419.32,2026-09-02,161768.99
3943,612,43749.52,2028-11-08,118019.47
3944,612,30032.52,2030-05-25,87986.95
3945,613,54847.9,2025-04-24,187727.63
3946,613,11632.07,2026-04-30,176095.56
3947,613,31690.56,2026-05-06,144405.0
3948,613,24923.13,2026-05-16,119481.87
3949,613,24137.18,2026-07-11,95344.69
3950,613,19204.16,2026-08-29,76140.53
3951,614,28742.06,2025-07-09,107730.81
3952,614,16766.15,2032-05-25,90964.66
3953,614,25115.77,2032-08-20,65848.89
3954,615,24235.27,2023-10-12,167544.1
3955,615,33093.13,2023-10-25,134450.97
3956,615,29852.96,2023-11-08,104598.01
3957,615,19307.28,2024-08-05,85290.73
3958,615,25114.21,2024-08-15,60176.52
3959,616,72126.7,2021-04-06,198866.86
3960,616,40394.01,2023-11-24,158472.85
3961,616,38588.26,2023-12-01,119884.59
3962,616,28281.9,2023-12-11,91602.69
3963,616,23643.33,2025-03-02,67959.36
3964,616,13534.09,2025-04-17,54425.27
3965,616,10870.8,2026-05-19,43554.47
3966,616,11756.19,2028-02-04,31798.28
3967,617,24157.54,2022-05-01,135912.33
3968,617,34434.81,2022-07-17,101477.52
3969,617,7495.48,2023-12-06,93982.04
3970,617,25660.51,2024-12-15,68321.53
3971,617,5388.2,2026-08-08,62933.33
3972,617,8000.08,2027-06-14,54933.25
3973,617,14130.08,2027-09-16,40803.17
3974,617,7875.0,2027-11-21,32928.17
3975,617,3141.64,2028-03-10,29786.53
3976,618,22905.98,2022-09-18,125861.79
3977,618,9933.4,2023-02-26,115928.39
3978,618,30691.58,2023-04-26,85236.81
3979,618,13507.3,2023-06-04,71729.51
3980,618,16343.82,2023-07-06,55385.69
3981,618,9192.21,2023-09-08,46193.48
3982,618,6118.53,2023-11-04,40074.95
3983,618,9943.03,2023-12-16,30131.92
3984,618,7943.17,2024-02-27,22188.75
3985,618,1302.52,2024-04-30,20886.23
3986,619,30323.29,2023-12-29,80082.92
3987,619,13164.28,2024-05-14,66918.64
3988,619,4711.14,2024-07-22,62207.5
3989,619,9401.95,2024-07-30,52805.55
3990,619,8595.85,2024-08-23,44209.7
3991,619,8169.5,2024-08-29,36040.2
3992,620,47693.72,2022-12-24,123310.4
3993,620,36893.77,2023-05-31,86416.63
3994,620,17485.8,2023-07-05,68930.83
3995,621,282.2,2022-02-22,5128.6
3996,621,777.0,2022-04-07,4351.6
3997,621,1225.86,2022-04-25,3125.74
3998,621,645.01,2022-07-30,2480.73
3999,621,404.09,2022-08-11,2076.64
4000,621,537.99,2022-10-13,1538.65
4001,621,350.06,2023-01-26,1188.59
4002,622,33170.61,2025-05-13,266538.88
4003,622,69384.07,2027-01-21,197154.81
4004,622,11726.38,2028-01-18,185428.43
4005,622,49046.63,2031-08-20,136381.8
4006,622,21455.5,2032-01-03,114926.3
4007,622,9986.3,2032-07-21,104940.0
4008,623,14142.48,2023-10-09,89921.5
4009,623,22109.5,2024-02-29,67812.0
4010,623,19057.31,2025-07-07,48754.69
4011,624,31634.88,2026-07-16,406248.08
4012,624,116119.15,2028-04-01,290128.93
4013,624,41667.66,2028-05-25,248461.27
4014,624,25413.44,2028-06-29,223047.83
4015,624,40866.99,2028-07-06,182180.84
4016,624,27134.25,2028-12-11,155046.59
4017,624,10013.03,2029-09-27,145033.56
4018,625,42348.6,2022-03-21,116901.11
4019,625,7326.59,2022-05-08,109574.52
4020,625,9991.57,2022-05-10,99582.95
4021,625,21348.29,2022-06-16,78234.66
4022,625,14856.47,2022-06-17,63378.19
4023,625,17953.45,2022-09-16,45424.74
4024,625,12738.46,2022-10-11,32686.28
4025,625,4939.48,2022-11-25,27746.8
4026,625,4840.85,2022-12-10,22905.95
4027,625,2046.54,2023-04-14,20859.41
4028,626,32374.35,2022-05-02,268604.42
4029,626,73266.44,2022-05-22,195337.98
4030,626,11026.55,2022-05-24,184311.43
4031,626,11423.95,2023-06-22,172887.48
4032,626,50342.96,2023-09-01,122544.52
4033,626,23305.2,2024-04-07,99239.32
4034,626,29351.58,2024-07-28,69887.74
4035,626,6117.46,2024-10-13,63770.28
4036,626,6283.03,2024-12-11,57487.25
4037,627,35986.74,2023-05-29,111113.89
4038,627,12763.12,2023-06-30,98350.77
4039,627,18174.01,2024-10-22,80176.76
4040,627,14364.89,2024-11-16,65811.87
4041,628,12902.68,2021-08-04,211944.6
4042,628,37770.7,2022-04-27,174173.9
4043,628,26262.99,2022-09-04,147910.91
4044,628,29765.61,2025-01-04,118145.3
4045,628,29496.95,2026-01-26,88648.35
4046,628,15740.82,2026-04-09,72907.53
4047,629,17489.4,2022-06-20,64103.54
4048,629,3651.81,2023-04-25,60451.73
4049,629,14634.69,2023-12-29,45817.04
4050,629,3271.68,2025-07-01,42545.36
4051,629,7927.1,2025-07-21,34618.26
4052,629,8092.93,2026-05-03,26525.33
4053,629,6189.43,2026-07-29,20335.9
4054,629,3655.33,2026-11-28,16680.57
4055,629,1278.14,2027-02-08,15402.43
4056,629,2439.05,2027-09-21,12963.38
4057,630,65014.22,2024-07-12,349859.26
4058,630,31397.49,2025-07-05,318461.77
4059,630,63784.24,2026-01-11,254677.53
4060,630,61121.19,2026-04-17,193556.34
4061,630,18935.24,2027-12-27,174621.1
4062,630,25395.41,2028-02-29,149225.69
4063,630,22388.52,2028-11-09,126837.17
4064,630,36727.07,2029-03-21,90110.1
4065,631,92388.12,2026-08-29,363587.69
4066,631,59655.99,2026-12-24,303931.7
4067,631,45655.8,2027-07-20,258275.9
4068,631,53779.27,2029-04-14,204496.63
4069,631,41095.55,2029-09-22,163401.08
4070,631,20946.47,2031-02-26,142454.61
4071,631,19905.76,2031-03-13,122548.85
4072,632,17183.9,2023-09-08,88003.54
4073,632,25011.27,2023-11-06,62992.27
4074,632,16041.96,2024-04-25,46950.31
4075,632,12240.72,2024-06-30,34709.59
4076,632,9664.82,2024-08-18,25044.77
4077,632,7261.85,2024-09-21,17782.92
4078,633,17438.69,2023-08-03,242023.49
4079,633,22102.42,2023-12-10,219921.07
4080,633,38479.27,2024-03-12,181441.8
4081,633,53202.45,2024-03-12,128239.35
4082,633,30911.85,2024-03-17,97327.5
4083,633,23284.55,2024-04-06,74042.95
4084,633,14060.25,2024-05-04,59982.7
4085,633,14694.55,2024-11-12,45288.15
4086,633,11230.97,2025-02-05,34057.18
4087,633,8097.41,2025-03-23,25959.77
4088,634,1997.69,2026-01-11,10407.47
4089,634,1896.55,2026-10-23,8510.92
4090,634,676.91,2031-06-17,7834.01
4091,635,99871.89,2024-08-22,273376.27
4092,635,78883.82,2025-04-19,194492.45
4093,635,28510.41,2025-07-21,165982.04
4094,635,31211.92,2026-03-17,134770.12
4095,635,20466.44,2026-04-14,114303.68
4096,635,6471.06,2026-04-27,107832.62
4097,636,15424.77,2021-11-30,37039.84
4098,636,5377.28,2022-08-25,31662.56
4099,636,5886.85,2023-08-03,25775.71
4100,636,4594.21,2024-01-16,21181.5
4101,636,3639.17,2024-02-25,17542.33
4102,636,2006.72,2024-07-20,15535.61
4103,636,3157.1,2026-03-23,12378.51
4104,636,844.63,2026-12-06,11533.88
4105,636,1633.29,2027-10-20,9900.59
4106,637,23418.82,2021-07-18,114529.66
4107,637,30554.65,2022-03-03,83975.01
4108,637,18021.9,2024-04-20,65953.11
4109,637,14052.05,2024-06-04,51901.06
4110,637,9737.91,2027-07-09,42163.15
4111,638,16084.51,2025-07-07,89924.54
4112,638,15681.16,2025-10-07,74243.38
4113,638,8900.19,2026-02-01,65343.19
4114,639,10613.47,2025-05-17,138456.41
4115,639,23325.72,2025-10-24,115130.69
4116,639,8555.61,2026-05-14,106575.08
4117,640,22277.76,2021-11-23,65911.32
4118,640,11110.08,2022-02-21,54801.24
4119,640,14337.26,2022-05-30,40463.98
4120,641,11273.43,2022-06-06,125193.18
4121,641,27067.77,2024-06-25,98125.41
4122,641,23364.39,2025-10-21,74761.02
4123,641,17701.24,2026-12-01,57059.78
4124,641,10216.29,2027-01-16,46843.49
4125,641,8565.51,2027-01-23,38277.98
4126,641,3253.99,2028-02-21,35023.99
4127,642,73999.49,2022-02-03,369853.18
4128,642,85443.37,2024-03-11,284409.81
4129,642,16257.59,2027-09-08,268152.22
4130,642,57088.12,2028-05-09,211064.1
4131,642,17124.61,2031-06-09,193939.49
4132,643,57908.09,2025-04-20,397266.88
4133,643,67267.22,2025-06-12,329999.66
4134,643,43558.27,2025-08-05,286441.39
4135,643,54063.13,2025-08-07,232378.26
4136,643,29055.18,2025-08-25,203323.08
4137,643,18158.1,2025-09-25,185164.98
4138,643,45884.79,2025-11-05,139280.19
4139,643,12351.5,2026-01-24,126928.69
4140,644,65589.81,2024-07-23,412459.75
4141,644,32258.73,2025-05-22,380201.02
4142,644,85797.61,2026-04-20,294403.41
4143,644,73344.47,2026-06-14,221058.94
4144,644,37376.57,2027-01-09,183682.37
4145,644,48735.55,2027-01-13,134946.82
4146,645,2815.0,2025-06-14,39987.66
4147,645,8542.44,2025-10-13,31445.22
4148,645,5590.57,2025-11-08,25854.65
4149,645,4607.98,2026-04-06,21246.67
4150,645,2248.81,2027-04-16,18997.86
4151,645,3968.45,2028-06-29,15029.41
4152,645,3238.17,2028-09-15,11791.24
4153,645,3061.35,2029-02-14,8729.89
4154,645,1306.14,2029-04-06,7423.75
4155,645,570.23,2029-05-25,6853.52
4156,646,11296.24,2023-04-27,44286.28
4157,646,6325.29,2023-07-18,37960.99
4158,646,10976.59,2026-12-15,26984.4
4159,646,1717.98,2027-03-19,25266.42
4160,647,52178.66,2024-05-12,196814.03
4161,647,24994.66,2024-06-01,171819.37
4162,647,23077.98,2024-10-12,148741.39
4163,647,39872.77,2024-11-15,108868.62
4164,647,17572.41,2024-11-26,91296.21
4165,648,37664.5,2025-01-06,172311.68
4166,648,15268.86,2025-07-15,157042.82
4167,648,41070.66,2025-09-20,115972.16
4168,648,13523.2,2025-11-10,102448.96
4169,648,6610.87,2026-01-18,95838.09
4170,648,20842.21,2026-04-14,74995.88
4171,648,17744.24,2026-05-24,57251.64
4172,649,63107.6,2022-11-19,213248.09
4173,649,23126.24,2023-02-09,190121.85
4174,649,10622.3,2023-11-21,179499.55
4175,649,30152.59,2024-08-04,149346.96
4176,649,20620.08,2026-02-12,128726.88
4177,649,6722.72,2026-02-19,122004.16
4178,649,31588.38,2026-11-26,90415.78
4179,649,10004.41,2027-02-02,80411.37
4180,650,4195.19,2024-02-17,34060.67
4181,650,8544.1,2024-03-11,25516.57
4182,650,7571.39,2024-07-03,17945.18
4183,651,23758.67,2025-01-27,159635.18
4184,651,23051.17,2025-05-05,136584.01
4185,651,30970.87,2025-11-30,105613.14
4186,651,23141.22,2028-04-19,82471.92
4187,651,20056.18,2028-10-03,62415.74
4188,651,4926.45,2029-03-11,57489.29
4189,652,84981.55,2024-07-10,211254.9
4190,652,19357.8,2024-09-30,191897.1
4191,652,33723.6,2024-10-14,158173.5
4192,652,32595.85,2024-10-21,125577.65
4193,652,15682.13,2025-01-27,109895.52
4194,652,16443.94,2025-04-29,93451.58
4195,652,5211.68,2025-06-06,88239.9
4196,653,40518.43,2023-05-18,124391.13
4197,653,30585.01,2023-08-31,93806.12
4198,653,27052.64,2023-11-06,66753.48
4199,654,7249.47,2025-02-10,76359.52
4200,654,19767.56,2025-05-16,56591.96
4201,654,16916.28,2025-09-30,39675.68
4202,654,7942.45,2026-11-09,31733.23
4203,654,8085.2,2028-02-27,23648.03
4204,654,5136.88,2028-07-18,18511.15
4205,654,3950.31,2029-02-19,14560.84
4206,654,1186.54,2029-11-13,13374.3
4207,654,3603.01,2030-12-18,9771.29
4208,655,52680.69,2021-11-22,396677.2
4209,655,107699.93,2021-11-24,288977.27
4210,655,83291.44,2021-12-01,205685.83
4211,655,44427.3,2022-06-02,161258.53
4212,655,25761.64,2025-09-05,135496.89
4213,655,35276.94,2026-09-20,100219.95
4214,655,13361.42,2026-12-02,86858.53
4215,656,47393.49,2024-12-13,129995.69
4216,656,22697.37,2025-11-10,107298.32
4217,656,25247.62,2029-08-23,82050.7
4218,656,8086.49,2030-01-13,73964.21
4219,656,10240.69,2033-06-05,63723.52
4220,657,37642.04,2022-12-08,442622.21
4221,657,77509.21,2023-01-29,365113.0
4222,657,64410.26,2023-10-30,300702.74
4223,657,80577.13,2024-01-24,220125.61
4224,657,13763.9,2024-05-29,206361.71
4225,657,15445.93,2025-09-15,190915.78
4226,657,55123.17,2026-06-12,135792.61
4227,657,30848.23,2027-07-23,104944.38
4228,657,7484.42,2029-05-21,97459.96
4229,657,5742.92,2029-11-11,91717.04
4230,658,18022.48,2023-09-06,321742.9
4231,658,42522.62,2027-08-03,279220.28
4232,658,65913.31,2031-08-10,213306.97
4233,659,33149.75,2023-11-28,156414.4
4234,659,36156.92,2025-04-16,120257.48
4235,659,23434.39,2025-08-19,96823.09
4236,659,9559.32,2025-09-30,87263.77
4237,659,12663.24,2028-02-18,74600.53
4238,659,10463.59,2028-06-06,64136.94
4239,659,8567.95,2028-09-16,55568.99
4240,659,10698.3,2029-03-21,44870.69
4241,659,8252.71,2029-06-16,36617.98
4242,659,3413.67,2029-09-26,33204.31
4243,660,34826.13,2025-08-31,142801.39
4244,660,35334.41,2026-01-04,107466.98
4245,660,30399.15,2026-03-26,77067.83
4246,660,10304.67,2026-08-13,66763.16
4247,660,8482.63,2027-06-19,58280.53
4248,660,8491.67,2029-01-09,49788.86
4249,661,63887.52,2024-06-13,207550.91
4250,661,24200.07,2024-09-20,183350.84
4251,661,28487.57,2027-12-13,154863.27
4252,662,120629.04,2025-11-11,288472.85
4253,662,53251.9,2026-09-26,235220.95
4254,662,47511.42,2026-11-23,187709.53
4255,662,36963.24,2027-08-11,150746.29
4256,662,18165.32,2030-08-12,132580.97
4257,662,28960.48,2031-06-15,103620.49
4258,662,16971.9,2031-08-24,86648.59
4259,662,15245.21,2033-02-23,71403.38
4260,663,74205.11,2025-02-08,320237.9
4261,663,73279.0,2025-09-02,246958.9
4262,663,42274.71,2026-07-29,204684.19
4263,663,12161.69,2027-08-01,192522.5
4264,663,18470.51,2028-04-14,174051.99
4265,663,42993.96,2028-07-01,131058.03
4266,663,24165.18,2028-11-25,106892.85
4267,664,78239.88,2023-01-21,409426.65
4268,664,54289.12,2023-04-25,355137.53
4269,664,81816.59,2023-07-24,273320.94
4270,664,74201.02,2023-10-02,199119.92
4271,664,34965.12,2023-11-04,164154.8
4272,664,17285.61,2024-08-18,146869.19
4273,664,35578.37,2025-05-15,111290.82
4274,664,13100.11,2026-10-27,98190.71
4275,664,12262.33,2026-11-06,85928.38
4276,665,42596.31,2024-09-26,155593.45
4277,665,11990.36,2025-05-10,143603.09
4278,665,14724.09,2026-06-22,128879.0
4279,665,31489.18,2027-02-14,97389.82
4280,665,25109.6,2028-02-01,72280.22
4281,665,7448.53,2029-09-24,64831.69
4282,665,11773.62,2030-03-22,53058.07
4283,665,12769.64,2030-03-29,40288.43
4284,665,4182.15,2030-05-16,36106.28
4285,666,6497.68,2022-06-30,84681.68
4286,666,10250.97,2023-02-19,74430.71
4287,666,15929.73,2023-04-01,58500.98
4288,666,17133.06,2023-07-04,41367.92
4289,666,8777.92,2025-03-06,32590.0
4290,666,3443.53,2025-12-03,29146.47
4291,666,8239.17,2026-08-18,20907.3
4292,667,645.37,2023-09-14,2805.15
4293,667,448.77,2023-11-29,2356.38
4294,667,506.87,2026-09-05,1849.51
4295,667,466.35,2031-06-06,1383.16
4296,667,245.59,2033-02-08,1137.57
4297,668,84746.2,2022-06-14,375308.92
4298,668,72741.98,2022-06-24,302566.94
4299,668,50903.26,2022-12-15,251663.68
4300,668,22360.64,2024-12-12,229303.04
4301,668,20981.16,2025-04-26,208321.88
4302,668,25247.26,2026-04-15,183074.62
4303,668,33040.42,2026-06-02,150034.2
4304,668,17176.68,2026-12-04,132857.52
4305,669,55334.61,2023-10-11,150587.94
4306,669,22589.98,2023-11-04,127997.96
4307,669,28661.57,2024-03-16,99336.39
4308,669,12220.81,2024-08-04,87115.58
4309,669,25063.57,2025-07-22,62052.01
4310,669,14510.55,2025-08-21,47541.46
4311,670,71535.58,2022-05-05,217793.71
4312,670,45530.8,2023-07-13,172262.91
4313,670,29784.32,2028-10-04,142478.59
4314,670,22786.4,2029-07-07,119692.19
4315,671,94069.13,2024-12-18,241535.71
4316,671,45692.47,2025-02-06,195843.24
4317,671,49421.35,2025-09-29,146421.89
4318,671,41251.0,2027-11-21,105170.89
4319,671,21931.11,2027-12-01,83239.78
4320,671,9721.43,2028-12-11,73518.35
4321,671,16333.03,2032-02-27,57185.32
4322,672,5213.56,2022-09-18,19346.78
4323,672,3248.34,2022-10-18,16098.44
4324,672,3849.19,2022-12-09,12249.25
4325,672,3668.96,2022-12-28,8580.29
4326,672,1566.16,2023-03-21,7014.13
4327,672,1349.14,2023-03-27,5664.99
4328,672,693.6,2023-05-02,4971.39
4329,672,983.41,2023-07-31,3987.98
4330,673,59450.29,2021-09-09,203101.54
4331,673,17678.9,2021-12-20,185422.64
4332,673,19265.39,2022-01-19,166157.25
4333,673,42630.66,2022-02-09,123526.59
4334,673,36175.44,2022-04-19,87351.15
4335,673,13496.34,2022-05-05,73854.81
4336,673,7844.42,2022-06-08,66010.39
4337,674,81360.48,2026-03-30,374039.66
4338,674,47684.53,2026-06-10,326355.13
4339,674,85201.13,2026-07-20,241154.0
4340,674,43139.99,2027-01-27,198014.01
4341,674,12188.52,2027-09-29,185825.49
4342,674,17044.87,2028-02-02,168780.62
4343,674,31789.52,2028-03-01,136991.1
4344,675,139079.9,2024-08-14,360526.13
4345,675,52167.47,2025-01-17,308358.66
4346,675,28983.5,2025-11-15,279375.16
4347,675,20968.39,2025-12-11,258406.77
4348,675,65653.29,2026-03-04,192753.48
4349,675,12326.1,2027-03-01,180427.38
4350,675,20325.43,2027-03-14,160101.95
4351,675,25752.03,2027-04-24,134349.92
4352,676,47112.89,2022-05-10,353443.72
4353,676,22832.62,2022-06-21,330611.1
4354,676,32943.99,2024-02-04,297667.11
4355,676,67977.97,2024-12-02,229689.14
4356,676,62461.84,2025-07-31,167227.3
4357,676,35510.46,2025-10-14,131716.84
4358,676,26198.26,2026-05-25,105518.58
4359,676,16090.42,2026-08-09,89428.16
4360,676,22235.03,2027-01-23,67193.13
4361,676,3842.24,2029-01-07,63350.89
4362,677,38436.31,2024-03-19,229516.08
4363,677,51573.69,2025-05-19,177942.39
4364,677,28010.08,2025-07-02,149932.31
4365,677,15151.97,2026-04-27,134780.34
4366,677,15128.62,2026-10-20,119651.72
4367,677,6075.77,2029-04-08,113575.95
4368,677,14292.57,2030-04-17,99283.38
4369,677,21517.5,2030-12-12,77765.88
4370,677,21592.45,2031-03-04,56173.43
4371,677,9460.27,2031-04-03,46713.16
4372,678,11229.43,2021-12-31,30921.33
4373,678,7209.51,2024-01-13,23711.82
4374,678,5308.55,2025-12-02,18403.27
4375,678,1684.16,2026-08-15,16719.11
4376,678,4460.89,2026-10-19,12258.22
4377,679,59621.12,2021-02-03,149527.76
4378,679,29359.78,2021-05-12,120167.98
4379,679,22473.0,2021-05-18,97694.98
4380,679,13414.79,2021-06-06,84280.19
4381,679,12786.51,2021-07-07,71493.68
4382,679,11042.07,2021-08-17,60451.61
4383,679,4052.97,2021-10-12,56398.64
4384,679,16374.11,2022-01-09,40024.53
4385,680,23280.98,2023-11-22,303691.52
4386,680,24890.52,2024-04-23,278801.0
4387,680,68478.61,2024-05-25,210322.39
4388,681,56625.43,2020-11-30,287860.08
4389,681,48553.72,2021-03-10,239306.36
4390,681,36473.97,2022-04-30,202832.39
4391,681,49777.09,2022-07-24,153055.3
4392,681,12507.04,2023-01-25,140548.26
4393,682,80236.66,2024-10-13,304833.27
4394,682,73585.02,2027-04-19,231248.25
4395,682,61388.9,2027-05-01,169859.35
4396,682,38851.34,2028-12-13,131008.01
4397,682,17399.25,2029-06-12,113608.76
4398,682,6286.16,2030-01-12,107322.6
4399,682,15127.98,2030-10-03,92194.62
4400,682,6126.6,2031-02-25,86068.02
4401,682,19615.42,2032-05-18,66452.6
4402,682,8003.52,2033-10-31,58449.08
4403,683,1002.33,2023-01-05,3807.94
4404,683,282.5,2023-01-09,3525.44
4405,683,348.38,2023-02-08,3177.06
4406,683,796.14,2023-06-18,2380.92
4407,683,297.63,2023-12-11,2083.29
4408,683,420.37,2024-04-15,1662.92
4409,683,271.09,2024-06-17,1391.83
4410,683,125.87,2024-06-23,1265.96
4411,684,38703.73,2026-01-06,356138.15
4412,684,70760.62,2026-03-21,285377.53
4413,684,38733.59,2026-12-20,246643.94
4414,684,73130.98,2031-02-07,173512.96
4415,684,41691.12,2031-10-01,131821.84
4416,685,4071.15,2025-09-10,11836.96
4417,685,942.59,2026-04-25,10894.37
4418,685,607.99,2029-09-27,10286.38
4419,685,2866.8,2029-12-03,7419.58
4420,685,487.86,2030-05-13,6931.72
4421,685,735.93,2031-01-19,6195.79
4422,685,1757.68,2031-03-11,4438.11
4423,685,1062.27,2031-03-23,3375.84
4424,685,487.34,2032-12-04,2888.5
4425,685,611.79,2033-02-19,2276.71
4426,686,22164.01,2022-05-07,202508.49
4427,686,33435.15,2027-10-12,169073.34
4428,686,34708.01,2028-05-31,134365.33
4429,686,10905.71,2028-06-26,123459.62
4430,686,18046.8,2028-12-22,105412.82
4431,687,4762.28,2024-08-20,32208.06
4432,687,4983.3,2025-09-06,27224.76
4433,687,2295.99,2025-12-28,24928.77
4434,687,3108.21,2027-01-19,21820.56
4435,687,4688.63,2029-02-01,17131.93
4436,687,3349.05,2029-05-01,13782.88
4437,687,3123.81,2030-04-08,10659.07
4438,688,54037.56,2024-10-07,201261.17
4439,688,35534.97,2025-08-08,165726.2
4440,688,34647.1,2025-11-09,131079.1
4441,688,25777.46,2026-06-03,105301.64
4442,688,9692.76,2026-08-30,95608.88
4443,689,6309.15,2020-12-13,61158.22
4444,689,15500.92,2020-12-19,45657.3
4445,689,11846.29,2021-03-30,33811.01
4446,689,7632.83,2021-05-19,26178.18
4447,689,7808.26,2021-05-25,18369.92
4448,689,4006.07,2022-02-23,14363.85
4449,689,1026.02,2022-05-08,13337.83
4450,689,3611.09,2022-06-30,9726.74
4451,689,2388.62,2022-07-18,7338.12
4452,690,23937.91,2022-06-17,165410.32
4453,690,47293.46,2022-08-14,118116.86
4454,690,30062.64,2023-05-19,88054.22
4455,690,19477.39,2023-09-19,68576.83
4456,691,21711.94,2024-07-14,101186.75
4457,691,28777.87,2024-12-12,72408.88
4458,691,9749.02,2026-03-24,62659.86
4459,691,7419.27,2027-04-05,55240.59
4460,691,7097.97,2029-02-24,48142.62
4461,692,34459.13,2021-12-26,142054.38
4462,692,32669.69,2022-04-08,109384.69
4463,692,25508.82,2022-06-02,83875.87
4464,692,8777.91,2022-12-12,75097.96
4465,693,5573.28,2023-12-18,19046.19
4466,693,3221.5,2027-11-28,15824.69
4467,693,2625.8,2030-09-30,13198.89
4468,694,58131.28,2021-08-29,277317.84
4469,694,76532.98,2022-02-21,200784.86
4470,694,24152.2,2023-05-04,176632.66
4471,694,38527.58,2024-06-22,138105.08
4472,694,22977.59,2025-08-16,115127.49
4473,694,17125.56,2025-10-04,98001.93
4474,694,24643.04,2026-05-10,73358.89
4475,695,36434.49,2021-07-06,149942.91
4476,695,23117.2,2022-01-17,126825.71
4477,695,14427.33,2022-03-23,112398.38
4478,695,8689.54,2022-08-26,103708.84
4479,695,30409.28,2023-05-07,73299.56
4480,695,6409.31,2023-08-30,66890.25
4481,696,90731.89,2022-08-08,371826.33
4482,696,54595.95,2022-12-08,317230.38
4483,696,51049.67,2023-10-26,266180.71
4484,696,14532.69,2026-01-11,251648.02
4485,696,70008.01,2026-11-21,181640.01
4486,696,52058.38,2029-03-06,129581.63
4487,696,18997.18,2029-04-24,110584.45
4488,697,38243.98,2022-06-09,457209.82
4489,697,58975.37,2022-06-14,398234.45
4490,697,73229.06,2022-10-08,325005.39
4491,697,19441.47,2023-10-15,305563.92
4492,697,26239.97,2024-01-13,279323.95
4493,697,46797.69,2024-02-17,232526.26
4494,697,36032.66,2024-05-24,196493.6
4495,697,37063.23,2024-12-23,159430.37
4496,698,88157.23,2022-10-26,212486.0
4497,698,26620.97,2022-12-20,185865.03
4498,698,37564.06,2023-02-20,148300.97
4499,698,14514.81,2024-03-21,133786.16
4500,699,7548.01,2025-09-28,95250.88
4501,699,24030.39,2025-12-11,71220.49
4502,699,6253.81,2026-04-26,64966.68
4503,699,11397.88,2026-07-12,53568.8
4504,699,9265.79,2028-04-20,44303.01
4505,699,6911.88,2028-11-26,37391.13
4506,699,2373.06,2029-05-15,35018.07
4507,699,5472.56,2030-02-21,29545.51
4508,699,4242.81,2030-06-07,25302.7
4509,699,5688.79,2032-10-14,19613.91
4510,700,45250.06,2021-09-01,426126.65
4511,700,24323.0,2022-09-03,401803.65
4512,700,47451.29,2023-04-24,354352.36
4513,700,106018.32,2024-02-27,248334.04
4514,700,59216.99,2024-10-30,189117.05
4515,700,42399.19,2025-03-02,146717.86
4516,701,40702.33,2025-08-20,397842.8
4517,701,118206.99,2025-11-08,279635.81
4518,701,43739.02,2026-04-24,235896.79
4519,701,30033.0,2026-12-12,205863.79
4520,701,55153.1,2027-03-27,150710.69
4521,702,20731.22,2025-09-29,103870.13
4522,702,9097.13,2025-10-03,94773.0
4523,702,17098.81,2026-02-23,77674.19
4524,702,8014.5,2027-03-21,69659.69
4525,702,5842.97,2028-09-24,63816.72
4526,702,18466.79,2028-09-24,45349.93
4527,702,5967.29,2030-08-14,39382.64
4528,702,11612.1,2032-09-13,27770.54
4529,702,7259.63,2032-09-22,20510.91
4530,703,8640.08,2022-12-27,78488.5
4531,703,15680.59,2024-03-12,62807.91
4532,703,6821.21,2025-05-07,55986.7
4533,703,10603.04,2027-01-31,45383.66
4534,703,3746.94,2027-05-03,41636.72
4535,703,7436.81,2027-07-27,34199.91
4536,703,7314.92,2028-06-12,26884.99
4537,704,44049.8,2025-10-11,358461.69
4538,704,106185.68,2026-07-11,252276.01
4539,704,45814.72,2026-12-25,206461.29
4540,704,39733.13,2027-10-13,166728.16
4541,704,17333.96,2028-12-24,149394.2
4542,704,43863.41,2029-03-09,105530.79
4543,704,6772.31,2030-02-21,98758.48
4544,704,27343.29,2032-05-20,71415.19
4545,704,5476.09,2032-07-09,65939.1
4546,704,14365.75,2032-07-15,51573.35
4547,705,71646.7,2024-01-14,267275.95
4548,705,40495.33,2024-04-16,226780.62
4549,705,59177.04,2024-07-14,167603.58
4550,705,16516.75,2028-10-31,151086.83
4551,706,55364.22,2022-03-17,166830.13
4552,706,12329.2,2022-08-19,154500.93
4553,706,26368.13,2024-01-14,128132.8
4554,706,22317.04,2024-01-19,105815.76
4555,706,12388.16,2024-06-18,93427.6
4556,706,10413.57,2026-08-31,83014.03
4557,706,18807.85,2026-09-10,64206.18
4558,706,9367.96,2026-09-20,54838.22
4559,706,6019.36,2026-11-24,48818.86
4560,706,8702.11,2027-10-04,40116.75
4561,707,10421.0,2024-10-14,27612.58
4562,707,4099.64,2024-10-24,23512.94
4563,707,1643.22,2025-03-11,21869.72
4564,707,6507.11,2025-05-02,15362.61
4565,707,4076.86,2025-10-23,11285.75
4566,707,2866.88,2026-01-22,8418.87
4567,707,1012.94,2026-04-22,7405.93
4568,708,69804.55,2025-01-20,284169.33
4569,708,34337.34,2025-05-27,249831.99
4570,708,21458.89,2025-09-11,228373.1
4571,708,46399.88,2026-09-27,181973.22
4572,708,26553.0,2027-11-11,155420.22
4573,708,18687.69,2027-12-04,136732.53
4574,708,19145.3,2028-02-24,117587.23
4575,708,11123.73,2028-07-19,106463.5
4576,708,6554.2,2028-11-25,99909.3
4577,709,31782.27,2026-01-10,277417.75
4578,709,38691.24,2030-06-09,238726.51
4579,709,67233.61,2031-10-27,171492.9
4580,709,34819.3,2031-12-08,136673.6
4581,710,81857.2,2029-05-18,246316.04
4582,710,70953.59,2030-02-25,175362.45
4583,710,49358.91,2031-10-05,126003.54
4584,711,91883.35,2023-08-19,313557.06
4585,711,68936.94,2024-01-20,244620.12
4586,711,15000.55,2024-03-29,229619.57
4587,711,35116.41,2025-04-08,194503.16
4588,711,35409.24,2025-04-23,159093.92
4589,711,35144.64,2025-08-10,123949.28
4590,711,16071.34,2025-10-19,107877.94
4591,711,8447.27,2026-01-04,99430.67
4592,711,29276.15,2026-01-04,70154.52
4593,711,17661.15,2026-01-05,52493.37
4594,712,18636.49,2022-01-29,71594.73
4595,712,15015.61,2025-03-07,56579.12
4596,712,3357.04,2025-05-23,53222.08
4597,712,6984.07,2025-11-24,46238.01
4598,712,12925.49,2026-01-08,33312.52
4599,712,8666.78,2026-02-26,24645.74
4600,712,3667.61,2026-03-24,20978.13
4601,712,5284.44,2028-03-16,15693.69
4602,712,4687.7,2028-11-20,11005.99
4603,712,950.94,2029-02-23,10055.05
4604,713,27740.67,2023-09-14,104922.37
4605,713,22766.46,2024-01-22,82155.91
4606,713,24382.79,2024-12-12,57773.12
4607,713,9895.17,2025-01-29,47877.95
4608,713,4577.14,2026-02-14,43300.81
4609,713,4579.42,2026-03-03,38721.39
4610,713,7977.83,2026-04-21,30743.56
4611,713,8653.81,2026-05-04,22089.75
4612,713,5083.81,2026-06-20,17005.94
4613,713,2732.92,2027-05-15,14273.02
4614,714,28450.03,2021-03-12,84126.26
4615,714,7187.39,2021-05-19,76938.87
4616,714,4567.35,2021-07-24,72371.52
4617,714,9132.54,2021-10-24,63238.98
4618,714,5789.9,2021-12-27,57449.08
4619,715,109547.98,2024-07-26,305294.58
4620,715,51109.41,2024-11-01,254185.17
4621,715,37464.29,2025-01-17,216720.88
4622,715,47890.48,2025-03-29,168830.4
4623,715,42682.55,2025-11-05,126147.85
4624,715,15903.26,2026-02-04,110244.59
4625,715,13601.55,2026-03-22,96643.04
4626,715,28758.62,2026-08-30,67884.42
4627,716,1765.61,2022-12-03,27331.82
4628,716,5362.29,2023-06-14,21969.53
4629,716,4917.01,2025-04-18,17052.52
4630,716,3730.71,2025-05-04,13321.81
4631,716,1367.27,2027-01-25,11954.54
4632,717,36503.08,2024-11-23,314774.48
4633,717,77456.96,2028-09-30,237317.52
4634,717,33205.52,2032-05-01,204112.0
4635,717,15001.01,2033-05-05,189110.99
4636,718,56032.56,2021-06-23,384368.66
4637,718,54589.26,2021-07-11,329779.4
4638,718,32859.06,2022-04-03,296920.34
4639,719,4498.34,2023-05-23,31076.61
4640,719,8270.71,2023-08-13,22805.9
4641,719,5754.01,2025-02-05,17051.89
4642,720,19501.85,2022-01-14,71902.06
4643,720,11536.81,2022-02-23,60365.25
4644,720,16158.26,2022-03-17,44206.99
4645,720,7123.4,2022-07-09,37083.59
4646,720,2307.27,2022-07-13,34776.32
4647,720,7523.63,2022-09-24,27252.69
4648,720,6330.26,2022-10-13,20922.43
4649,720,3933.51,2022-11-10,16988.92
4650,721,56931.28,2027-08-19,287910.22
4651,721,65432.31,2029-04-29,222477.91
4652,721,45013.83,2030-05-27,177464.08
4653,721,41100.52,2031-02-04,136363.56
4654,721,10623.29,2032-02-08,125740.27
4655,722,50475.2,2026-01-04,151199.3
4656,722,43067.99,2026-06-03,108131.31
4657,722,16043.99,2026-07-19,92087.32
4658,722,5498.63,2028-06-11,86588.69
4659,722,19827.43,2028-06-15,66761.26
4660,722,14643.94,2029-11-01,52117.32
4661,723,39421.91,2023-08-11,95524.72
4662,723,19088.41,2023-08-20,76436.31
4663,723,11807.1,2024-11-18,64629.21
4664,723,17456.79,2025-11-21,47172.42
4665,723,3353.17,2026-10-04,43819.25
4666,723,12965.25,2027-08-28,30854.0
4667,724,5656.22,2024-02-15,74666.01
4668,724,11966.83,2027-03-03,62699.18
4669,724,10181.84,2028-02-23,52517.34
4670,724,10564.28,2029-10-01,41953.06
4671,725,67983.29,2021-05-04,159525.5
4672,725,31733.22,2021-05-08,127792.28
4673,725,27169.58,2022-01-07,100622.7
4674,725,10382.38,2022-06-11,90240.32
4675,725,10509.66,2024-08-16,79730.66
4676,725,11164.56,2024-10-08,68566.1
4677,726,15495.59,2029-02-15,171821.52
4678,726,49710.14,2029-12-23,122111.38
4679,726,26146.79,2030-01-03,95964.59
4680,726,19430.55,2032-03-26,76534.04
4681,727,62788.25,2024-04-15,152410.56
4682,727,14287.16,2025-03-16,138123.4
4683,727,36989.05,2027-02-16,101134.35
4684,728,12984.79,2027-08-04,222935.76
4685,728,65311.75,2027-09-03,157624.01
4686,728,41509.8,2029-11-17,116114.21
4687,728,9721.54,2030-03-15,106392.67
4688,728,26909.19,2031-02-10,79483.48
4689,728,9724.51,2031-06-14,69758.97
4690,728,5387.02,2031-09-24,64371.95
4691,729,42253.49,2020-11-28,396116.39
4692,729,81507.61,2021-02-27,314608.78
4693,729,19457.12,2021-03-09,295151.66
4694,729,43153.41,2021-04-19,251998.25
4695,729,58101.24,2021-06-15,193897.01
4696,729,44777.72,2021-06-25,149119.29
4697,729,40918.5,2021-09-24,108200.79
4698,729,16520.28,2022-03-13,91680.51
4699,729,13908.06,2022-04-29,77772.45
4700,729,4669.89,2022-07-09,73102.56
4701,730,70645.95,2022-06-17,213333.77
4702,730,33918.99,2023-01-21,179414.78
4703,730,18237.14,2026-03-04,161177.64
4704,730,46391.23,2026-10-11,114786.41
4705,730,5864.95,2028-11-07,108921.46
4706,730,26612.94,2029-03-04,82308.52
4707,730,9116.27,2030-04-24,73192.25
4708,731,9537.15,2024-09-03,54149.82
4709,731,8427.37,2024-09-14,45722.45
4710,731,11982.72,2025-05-31,33739.73
4711,731,2974.26,2027-01-02,30765.47
4712,731,2944.42,2027-02-01,27821.05
4713,731,7622.89,2027-02-22,20198.16
4714,731,3379.18,2027-09-15,16818.98
4715,731,4781.38,2028-04-11,12037.6
4716,731,1737.02,2029-02-11,10300.58
4717,731,1327.7,2029-07-25,8972.88
4718,732,370.23,2025-06-03,4952.79
4719,732,623.36,2026-01-10,4329.43
4720,732,888.79,2026-01-14,3440.64
4721,733,56182.5,2023-08-10,438805.08
4722,733,119677.49,2023-10-02,319127.59
4723,733,51528.91,2024-02-10,267598.68
4724,733,24256.55,2024-03-15,243342.13
4725,733,38233.52,2024-07-14,205108.61
4726,734,26657.53,2025-03-23,210831.46
4727,734,44211.2,2025-09-01,166620.26
4728,734,42173.91,2027-05-03,124446.35
4729,734,28243.39,2027-06-30,96202.96
4730,734,27069.79,2029-02-04,69133.17
4731,734,16327.29,2032-06-15,52805.88
4732,735,18146.42,2022-12-28,259122.31
4733,735,21266.22,2024-12-06,237856.09
4734,735,59628.11,2026-12-21,178227.98
4735,735,18398.87,2030-03-29,159829.11
4736,735,34349.37,2032-02-12,125479.74
4737,736,9751.37,2026-09-08,52855.86
4738,736,4340.88,2026-12-22,48514.98
4739,736,9973.29,2028-05-19,38541.69
4740,736,6129.67,2030-04-18,32412.02
4741,736,5901.46,2030-06-23,26510.56
4742,736,3315.56,2031-02-04,23195.0
4743,737,20124.77,2022-06-18,205515.4
4744,737,22840.12,2023-08-07,182675.28
4745,737,26393.74,2024-04-01,156281.54
4746,738,54712.06,2023-08-16,403561.1
4747,738,28131.86,2023-09-19,375429.24
4748,738,46993.06,2023-11-28,328436.18
4749,738,66061.98,2024-01-25,262374.2
4750,738,48880.58,2024-05-26,213493.62
4751,738,39080.07,2024-06-22,174413.55
4752,738,34103.87,2024-07-15,140309.68
4753,738,21585.41,2024-07-15,118724.27
4754,739,119251.58,2023-07-04,320790.84
4755,739,94126.01,2023-07-26,226664.83
4756,739,54997.08,2023-08-16,171667.75
4757,739,46748.68,2023-09-30,124919.07
4758,739,20576.99,2024-07-15,104342.08
4759,739,18855.73,2024-08-17,85486.35
4760,739,5275.06,2025-07-28,80211.29
4761,740,3568.75,2021-05-14,31282.48
4762,740,8292.48,2021-08-06,22990.0
4763,740,4864.21,2022-04-04,18125.79
4764,740,3428.84,2022-10-02,14696.95
4765,740,1710.73,2024-03-30,12986.22
4766,740,2606.97,2028-06-05,10379.25
4767,740,2561.3,2029-08-10,7817.95
4768,740,983.63,2029-11-12,6834.32
4769,741,989.77,2025-08-26,12784.84
4770,741,3320.48,2026-10-29,9464.36
4771,741,2558.03,2027-07-12,6906.33
4772,741,718.3,2028-08-16,6188.03
4773,741,1036.29,2030-08-04,5151.74
4774,741,645.89,2031-11-08,4505.85
4775,742,110320.69,2020-09-30,297014.86
4776,742,73623.88,2022-12-08,223390.98
4777,742,65233.5,2023-01-06,158157.48
4778,742,11046.26,2023-07-07,147111.22
4779,742,15163.86,2025-01-14,131947.36
4780,742,26480.29,2025-03-29,105467.07
4781,742,14262.61,2025-06-01,91204.46
4782,742,11731.44,2026-04-29,79473.02
4783,742,7077.81,2026-06-10,72395.21
4784,743,57445.44,2023-03-20,277915.86
4785,743,47869.81,2023-10-26,230046.05
4786,743,31489.84,2024-06-30,198556.21
4787,743,58147.97,2025-03-24,140408.24
4788,743,30686.02,2025-05-16,109722.22
4789,744,73678.86,2024-07-30,366840.78
4790,744,62293.66,2025-02-09,304547.12
4791,744,74259.2,2025-04-22,230287.92
4792,744,44308.66,2025-06-24,185979.26
4793,744,38279.37,2026-12-01,147699.89
4794,744,29781.52,2027-04-28,117918.37
4795,745,25558.75,2024-01-10,388194.35
4796,745,93128.75,2024-04-26,295065.6
4797,745,71353.78,2024-08-30,223711.82
4798,745,43658.81,2024-12-06,180053.01
4799,745,36092.16,2025-02-12,143960.85
4800,745,31025.77,2025-11-24,112935.08
4801,745,30296.06,2025-11-26,82639.02
4802,746,110308.1,2025-02-09,306131.82
4803,746,71995.38,2025-03-24,234136.44
4804,746,44080.98,2025-05-20,190055.46
4805,746,51880.31,2025-12-12,138175.15
4806,746,37186.14,2026-01-27,100989.01
4807,746,8404.37,2026-04-06,92584.64
4808,746,15897.46,2026-05-05,76687.18
4809,746,7087.14,2026-06-01,69600.04
4810,746,19947.29,2026-06-12,49652.75
4811,747,12421.41,2028-08-26,57195.27
4812,747,3827.28,2029-01-26,53367.99
4813,747,13729.1,2029-08-03,39638.89
4814,747,9098.13,2032-09-02,30540.76
4815,747,7826.88,2032-12-17,22713.88
4816,748,32224.69,2022-04-19,118885.72
4817,748,18508.51,2022-04-29,100377.21
4818,748,5869.79,2022-05-13,94507.42
4819,748,11694.07,2023-01-24,82813.35
4820,748,14385.6,2023-03-09,68427.75
4821,748,11710.04,2023-05-26,56717.71
4822,748,7452.16,2023-09-06,49265.55
4823,748,9854.1,2024-10-06,39411.45
4824,748,10199.13,2025-01-13,29212.32
4825,749,39978.55,2025-06-17,396739.28
4826,749,75806.29,2025-06-26,320932.99
4827,749,90966.02,2025-07-19,229966.97
4828,749,51238.69,2025-11-01,178728.28
4829,749,19001.71,2025-11-28,159726.57
4830,749,34342.01,2026-01-21,125384.56
4831,750,13208.22,2024-01-18,167230.45
4832,750,27129.91,2024-01-29,140100.54
4833,750,26004.74,2024-06-27,114095.8
4834,750,9907.42,2024-08-04,104188.38
4835,750,29896.97,2025-01-01,74291.41
4836,750,12499.96,2025-05-07,61791.45
4837,750,5175.65,2025-05-29,56615.8
4838,751,45545.3,2023-05-23,151292.12
4839,751,30743.71,2023-08-03,120548.41
4840,751,30106.73,2024-08-29,90441.68
4841,751,23331.88,2024-12-22,67109.8
4842,751,17282.1,2025-06-17,49827.7
4843,751,12331.02,2026-01-13,37496.68
4844,751,5822.48,2026-04-01,31674.2
4845,751,3832.73,2026-04-06,27841.47
4846,751,7942.2,2026-12-26,19899.27
4847,752,7548.72,2022-03-19,21896.21
4848,752,2193.61,2023-08-11,19702.6
4849,752,2537.07,2024-01-26,17165.53
4850,752,4528.01,2024-02-18,12637.52
4851,752,2581.41,2024-10-02,10056.11
4852,752,1434.95,2024-12-08,8621.16
4853,752,2479.86,2024-12-18,6141.3
4854,752,989.78,2025-01-16,5151.52
4855,752,1080.59,2025-04-30,4070.93
4856,752,1203.14,2025-11-17,2867.79
4857,753,90120.08,2023-03-19,309805.83
4858,753,45153.05,2023-07-09,264652.78
4859,753,62275.38,2023-07-21,202377.4
4860,753,57041.67,2023-09-27,145335.73
4861,753,20921.42,2023-10-24,124414.31
4862,753,25333.57,2024-07-28,99080.74
4863,753,15362.76,2024-10-07,83717.98
4864,753,15492.46,2024-10-17,68225.52
4865,753,10107.42,2025-05-28,58118.1
4866,754,17071.49,2021-06-10,42576.96
4867,754,12167.38,2023-11-06,30409.58
4868,754,8631.57,2024-01-13,21778.01
4869,754,5975.74,2025-08-19,15802.27
4870,754,2358.18,2025-10-12,13444.09
4871,755,31064.71,2023-10-05,144123.47
4872,755,37638.24,2026-06-06,106485.23
4873,755,31036.64,2027-01-19,75448.59
4874,755,17064.72,2028-02-21,58383.87
4875,755,11810.14,2028-03-27,46573.73
4876,755,11049.57,2028-07-19,35524.16
4877,756,77636.39,2025-08-31,367847.24
4878,756,64424.24,2026-03-05,303423.0
4879,756,29943.23,2026-08-31,273479.77
4880,756,39283.78,2026-11-07,234195.99
4881,756,63027.14,2027-01-28,171168.85
4882,757,14782.05,2021-05-22,217696.36
4883,757,15335.42,2021-07-12,202360.94
4884,757,18813.6,2021-11-22,183547.34
4885,757,13827.87,2021-12-14,169719.47
4886,757,45175.42,2022-03-29,124544.05
4887,758,27854.95,2022-08-02,83384.28
4888,758,20841.19,2022-12-26,62543.09
4889,758,15177.2,2023-10-19,47365.89
4890,758,9289.69,2023-12-03,38076.2
4891,758,5959.68,2024-01-07,32116.52
4892,758,2903.81,2024-10-28,29212.71
4893,759,49176.2,2022-09-06,141144.06
4894,759,30536.05,2027-03-13,110608.01
4895,759,21964.56,2027-07-09,88643.45
4896,759,5646.07,2027-07-13,82997.38
4897,760,27290.43,2025-03-30,134706.52
4898,760,20009.03,2025-04-02,114697.49
4899,760,10904.89,2025-05-03,103792.6
4900,760,22377.01,2025-07-29,81415.59
4901,760,10023.98,2025-12-16,71391.61
4902,760,7076.85,2026-03-26,64314.76
4903,760,15667.56,2027-04-10,48647.2
4904,760,4002.42,2028-08-22,44644.78
4905,761,12044.88,2024-01-23,131471.51
4906,761,34761.77,2024-10-26,96709.74
4907,761,5027.56,2025-03-09,91682.18
4908,761,26997.09,2026-04-19,64685.09
4909,761,13320.08,2026-10-29,51365.01
4910,762,30603.67,2026-05-01,105228.97
4911,762,28384.78,2029-07-28,76844.19
4912,762,16370.92,2032-06-12,60473.27
4913,763,35842.73,2025-08-29,87344.32
4914,763,19397.3,2025-10-15,67947.02
4915,763,19590.8,2026-04-04,48356.22
4916,763,13417.03,2026-09-01,34939.19
4917,763,8463.85,2027-06-25,26475.34
4918,763,7265.02,2027-07-03,19210.32
4919,763,3898.05,2028-02-19,15312.27
4920,763,3289.18,2028-03-15,12023.09
4921,764,1368.74,2023-08-23,18102.33
4922,764,3910.12,2023-09-12,14192.21
4923,764,2449.11,2025-04-14,11743.1
4924,764,2153.17,2027-06-14,9589.93
4925,764,2191.99,2030-06-27,7397.94
4926,764,709.42,2030-07-21,6688.52
4927,764,841.24,2030-11-24,5847.28
4928,764,559.12,2030-12-22,5288.16
4929,765,77436.09,2023-12-12,400070.44
4930,765,43130.21,2024-03-25,356940.23
4931,765,56559.89,2024-04-18,300380.34
4932,765,36119.04,2024-05-12,264261.3
4933,765,60325.08,2025-06-09,203936.22
4934,765,20392.77,2025-08-21,183543.45
4935,766,53635.93,2025-12-22,351426.87
4936,766,28310.86,2026-11-26,323116.01
4937,766,56182.85,2028-10-01,266933.16
4938,767,5755.8,2025-01-03,59775.3
4939,767,10387.84,2025-04-10,49387.46
4940,767,3085.99,2025-06-17,46301.47
4941,767,2497.54,2025-12-06,43803.93
4942,767,4957.81,2026-08-10,38846.12
4943,767,2222.35,2026-11-10,36623.77
4944,767,9706.82,2027-07-15,26916.95
4945,767,3060.32,2027-07-23,23856.63
4946,767,1556.83,2028-04-05,22299.8
4947,767,2083.22,2030-03-05,20216.58
4948,768,67993.31,2023-09-26,342726.92
4949,768,75923.98,2023-12-05,266802.94
4950,768,39945.7,2025-01-14,226857.24
4951,768,35580.33,2025-08-20,191276.91
4952,768,26904.91,2027-06-14,164372.0
4953,768,24029.15,2027-06-21,140342.85
4954,769,26946.91,2025-07-11,256940.63
4955,769,56815.0,2025-10-15,200125.63
4956,769,44777.33,2026-12-28,155348.3
4957,769,32818.57,2028-01-07,122529.73
4958,769,8756.71,2028-01-21,113773.02
4959,769,8407.11,2029-11-18,105365.91
4960,770,52944.04,2022-06-15,147772.15
4961,770,40391.31,2023-01-08,107380.84
4962,770,15217.06,2024-01-16,92163.78
4963,771,752.3,2025-10-15,2107.98
4964,771,560.06,2026-07-24,1547.92
4965,771,431.69,2026-12-20,1116.23
4966,771,99.27,2028-01-20,1016.96
4967,771,97.33,2028-07-30,919.63
4968,771,264.25,2030-07-16,655.38
4969,772,5126.55,2020-12-03,23390.54
4970,772,2707.57,2021-02-12,20682.97
4971,772,3041.15,2021-02-20,17641.82
4972,772,4055.09,2021-03-03,13586.73
4973,772,3292.17,2021-07-03,10294.56
4974,772,1975.84,2021-07-10,8318.72
4975,772,2374.1,2022-09-17,5944.62
4976,772,646.08,2022-11-05,5298.54
4977,773,54232.35,2020-09-19,135417.99
4978,773,7523.33,2020-10-01,127894.66
4979,773,15203.07,2020-12-24,112691.59
4980,773,31730.81,2021-05-08,80960.78
4981,773,12169.19,2021-07-05,68791.59
4982,773,18723.35,2021-08-06,50068.24
4983,774,6349.53,2026-08-10,119398.88
4984,774,9883.57,2026-09-01,109515.31
4985,774,19176.36,2029-03-02,90338.95
4986,774,17953.32,2029-11-19,72385.63
4987,774,13856.86,2030-03-25,58528.77
4988,774,7328.67,2031-05-14,51200.1
4989,775,35921.73,2027-08-01,305137.59
4990,775,16897.26,2028-10-01,288240.33
4991,775,78022.49,2030-08-18,210217.84
4992,775,39912.65,2031-01-08,170305.19
4993,775,42846.37,2032-01-22,127458.82
4994,776,71246.32,2024-04-07,265733.03
4995,776,16095.36,2024-07-29,249637.67
4996,776,26873.92,2024-12-30,222763.75
4997,776,19037.04,2027-03-23,203726.71
4998,776,54218.13,2027-12-10,149508.58
4999,776,11670.01,2028-01-01,137838.57
5000,776,23459.53,2028-08-17,114379.04
5001,777,50259.57,2025-05-10,247302.25
5002,777,20445.57,2025-05-23,226856.68
5003,777,22912.43,2025-08-28,203944.25
5004,777,18712.63,2025-12-20,185231.62
5005,777,54400.57,2026-06-05,130831.05
5006,777,8293.51,2026-11-18,122537.54
5007,777,31649.94,2026-11-30,90887.6
5008,777,21095.06,2027-01-09,69792.54
5009,777,10806.83,2027-01-21,58985.71
5010,778,35610.24,2022-06-17,402739.05
5011,778,66481.97,2022-10-12,336257.08
5012,778,60924.31,2023-11-15,275332.77
5013,778,30802.99,2025-09-27,244529.78
5014,778,60785.61,2026-04-09,183744.17
5015,778,50578.29,2029-01-31,133165.88
5016,779,12112.49,2026-07-02,52851.76
5017,779,15739.88,2027-07-22,37111.88
5018,779,5101.0,2028-02-27,32010.88
5019,780,72147.58,2021-01-16,357763.83
5020,780,95388.11,2021-07-02,262375.72
5021,780,66463.46,2021-07-24,195912.26
5022,780,40080.1,2022-04-16,155832.16
5023,780,40705.61,2022-06-21,115126.55
5024,780,33435.34,2022-12-04,81691.21
5025,781,53447.94,2022-03-16,219009.75
5026,781,47807.68,2023-04-03,171202.07
5027,781,33596.05,2023-09-17,137606.02
5028,781,24457.53,2027-05-03,113148.49
5029,781,31620.57,2027-06-01,81527.92
5030,782,19135.8,2023-04-20,66793.38
5031,782,15124.16,2024-05-02,51669.22
5032,782,8450.76,2025-07-28,43218.46
5033,782,3370.6,2025-12-28,39847.86
5034,782,7250.65,2028-07-09,32597.21
5035,782,6679.27,2028-12-12,25917.94
5036,782,3309.84,2030-11-12,22608.1
5037,782,1855.53,2031-11-09,20752.57
5038,782,2201.49,2033-03-07,18551.08
5039,783,96412.1,2022-07-29,266581.66
5040,783,51575.36,2024-05-02,215006.3
5041,783,37990.11,2026-01-10,177016.19
5042,783,16697.1,2027-05-16,160319.09
5043,783,25831.56,2028-09-01,134487.53
5044,783,35669.8,2028-12-05,98817.73
5045,783,15059.08,2029-10-15,83758.65
5046,784,26308.7,2024-05-07,343480.39
5047,784,82351.99,2024-10-10,261128.4
5048,784,35877.02,2025-09-05,225251.38
5049,784,42056.91,2025-10-19,183194.47
5050,784,25629.29,2026-02-17,157565.18
5051,784,22504.29,2026-05-01,135060.89
5052,784,15917.36,2027-02-02,119143.53
5053,784,20184.99,2027-03-19,98958.54
5054,784,19161.57,2027-03-30,79796.97
5055,785,20005.65,2022-10-30,298028.82
5056,785,82282.01,2023-05-14,215746.81
5057,785,18524.5,2023-07-04,197222.31
5058,785,34604.34,2025-12-28,162617.97
5059,785,43477.89,2029-12-13,119140.08
5060,786,34825.43,2023-06-05,145275.11
5061,786,38300.52,2023-07-30,106974.59
5062,786,16964.89,2023-07-31,90009.7
5063,786,7249.49,2023-10-06,82760.21
5064,786,5258.66,2023-10-09,77501.55
5065,787,422.4,2026-10-29,7915.28
5066,787,826.52,2027-05-23,7088.76
5067,787,1589.92,2030-08-27,5498.84
5068,787,1164.1,2031-03-09,4334.74
5069,787,422.21,2032-03-05,3912.53
5070,787,608.86,2032-05-09,3303.67
5071,788,27034.2,2024-01-14,373823.85
5072,788,111560.86,2024-05-05,262262.99
5073,788,50479.96,2024-05-08,211783.03
5074,788,63325.3,2024-05-29,148457.73
5075,788,24652.69,2024-10-03,123805.04
5076,788,23268.09,2025-02-11,100536.95
5077,788,9684.56,2025-08-02,90852.39
5078,788,6841.82,2026-03-15,84010.57
5079,788,15934.12,2026-07-18,68076.45
5080,789,18253.05,2023-01-13,217940.19
5081,789,44377.81,2023-06-11,173562.38
5082,789,38170.21,2023-08-16,135392.17
5083,789,23853.5,2024-02-01,111538.67
5084,789,22910.72,2024-07-08,88627.95
5085,789,6587.9,2024-12-18,82040.05
5086,789,19660.33,2025-02-14,62379.72
5087,790,27964.18,2024-03-19,156328.65
5088,790,33207.98,2025-09-13,123120.67
5089,790,32421.5,2026-03-30,90699.17
5090,790,14882.55,2026-07-20,75816.62
5091,791,31440.71,2021-06-24,84197.45
5092,791,12224.47,2023-11-05,71972.98
5093,791,4109.65,2024-10-02,67863.33
5094,791,14630.87,2024-11-24,53232.46
5095,791,7060.38,2025-10-27,46172.08
5096,792,106850.62,2024-06-19,312257.31
5097,792,37695.57,2025-03-04,274561.74
5098,792,27186.71,2025-05-09,247375.03
5099,792,71908.4,2026-01-01,175466.63
5100,792,33945.41,2028-06-17,141521.22
5101,792,36248.22,2029-02-20,105273.0
5102,792,28227.09,2029-04-02,77045.91
5103,792,22277.26,2031-01-11,54768.65
5104,792,6155.14,2031-11-01,48613.51
5105,792,10744.74,2032-01-04,37868.77
5106,793,65655.28,2022-10-06,199331.21
5107,793,18543.26,2022-12-25,180787.95
5108,793,47655.34,2023-05-06,133132.61
5109,793,29517.21,2023-08-28,103615.4
5110,793,12240.99,2023-12-09,91374.41
5111,793,12595.59,2024-01-26,78778.82
5112,794,20627.39,2021-04-24,143332.09
5113,794,30957.43,2022-05-24,112374.66
5114,794,25680.13,2022-07-21,86694.53
5115,794,16536.07,2022-10-07,70158.46
5116,795,22713.07,2023-12-12,96240.3
5117,795,14014.28,2023-12-27,82226.02
5118,795,8699.01,2024-06-23,73527.01
5119,795,10657.45,2024-10-01,62869.56
5120,795,9932.66,2025-06-09,52936.9
5121,795,14990.42,2025-09-09,37946.48
5122,795,8149.84,2026-01-03,29796.64
5123,795,3354.08,2026-05-09,26442.56
5124,795,2059.75,2026-05-10,24382.81
5125,795,3089.85,2026-05-13,21292.96
5126,796,12549.26,2021-11-01,197861.46
5127,796,33983.76,2022-09-11,163877.7
5128,796,15291.47,2023-05-01,148586.23
5129,796,17793.29,2025-03-13,130792.94
5130,796,16893.08,2025-09-01,113899.86
5131,796,14406.11,2026-02-09,99493.75
5132,796,8920.28,2026-04-02,90573.47
5133,796,5670.54,2026-04-03,84902.93
5134,796,5829.21,2026-12-15,79073.72
5135,797,26690.75,2022-07-08,333664.4
5136,797,55174.58,2026-03-29,278489.82
5137,797,61752.59,2026-08-31,216737.23
5138,797,23823.82,2029-07-27,192913.41
5139,798,55154.85,2021-10-28,245244.2
5140,798,30750.81,2023-04-05,214493.39
5141,798,38630.14,2023-10-29,175863.25
5142,799,50238.94,2023-12-08,277259.94
5143,799,33313.17,2024-08-04,243946.77
5144,799,20533.11,2026-04-17,223413.66
5145,799,27145.11,2027-04-06,196268.55
5146,799,32449.03,2027-04-28,163819.52
5147,799,44966.47,2027-05-04,118853.05
5148,799,7250.7,2027-12-15,111602.35
5149,799,21610.89,2029-01-25,89991.46
5150,799,21545.64,2029-04-26,68445.82
5151,800,61845.44,2023-12-08,256625.44
5152,800,62292.67,2025-02-08,194332.77
5153,800,26400.36,2025-07-03,167932.41
5154,800,30835.59,2025-10-10,137096.82
5155,800,32305.39,2026-08-03,104791.43
5156,800,7085.73,2026-08-04,97705.7
5157,800,15389.83,2026-11-07,82315.87
5158,800,5520.32,2026-11-22,76795.55
5159,800,17917.6,2026-12-05,58877.95
5160,800,6437.63,2027-02-10,52440.32
5161,801,89210.42,2024-12-10,331689.94
5162,801,30392.44,2025-08-19,301297.5
5163,801,28382.8,2026-03-08,272914.7
5164,801,61367.26,2026-06-24,211547.44
5165,801,42751.86,2027-10-07,168795.58
5166,801,8493.6,2028-05-10,160301.98
5167,801,24317.76,2028-06-29,135984.22
5168,802,30295.22,2024-11-12,101978.18
5169,802,5348.75,2025-06-04,96629.43
5170,802,17475.46,2025-07-22,79153.97
5171,802,8926.79,2027-02-20,70227.18
5172,803,77012.52,2026-03-26,225310.92
5173,803,37604.45,2027-06-02,187706.47
5174,803,31785.6,2027-08-02,155920.87
5175,803,43767.19,2028-01-12,112153.68
5176,804,17191.31,2023-12-23,298227.25
5177,804,18292.57,2024-03-28,279934.68
5178,804,17029.05,2024-10-15,262905.63
5179,804,39917.98,2024-10-17,222987.65
5180,804,33018.23,2025-05-08,189969.42
5181,804,38411.9,2025-08-29,151557.52
5182,804,41471.99,2027-03-02,110085.53
5183,804,29302.75,2027-05-21,80782.78
5184,804,16525.92,2027-06-01,64256.86
5185,805,66293.8,2022-02-03,431856.68
5186,805,107791.03,2024-12-12,324065.65
5187,805,76234.22,2025-01-21,247831.43
5188,805,44569.93,2025-05-31,203261.5
5189,805,27334.13,2025-07-20,175927.37
5190,805,47945.45,2025-08-23,127981.92
5191,805,19960.19,2025-11-28,108021.73
5192,805,31126.0,2026-04-23,76895.73
5193,806,41014.04,2022-11-17,372489.85
5194,806,62481.86,2023-08-05,310007.99
5195,806,30192.44,2024-03-16,279815.55
5196,806,27454.33,2024-08-07,252361.22
5197,806,18432.83,2025-01-05,233928.39
5198,806,25227.95,2025-03-27,208700.44
5199,806,36059.08,2025-04-28,172641.36
5200,806,21854.09,2025-05-28,150787.27
5201,806,38023.44,2025-08-20,112763.83
5202,807,45709.25,2022-09-09,449497.32
5203,807,36157.07,2024-11-20,413340.25
5204,807,77115.29,2025-10-19,336224.96
5205,807,60579.81,2025-10-29,275645.15
5206,807,77715.95,2026-08-02,197929.2
5207,807,57335.59,2026-11-03,140593.61
5208,807,40151.25,2028-02-14,100442.36
5209,807,26995.27,2028-07-05,73447.09
5210,807,16768.08,2029-11-21,56679.01
5211,807,4152.34,2030-03-01,52526.67
5212,808,24728.16,2024-07-06,118006.13
5213,808,21880.36,2024-10-05,96125.77
5214,808,18185.1,2024-10-30,77940.67
5215,808,5962.88,2024-11-08,71977.79
5216,808,15405.11,2025-02-10,56572.68
5217,808,2910.39,2025-10-15,53662.29
5218,808,5295.19,2025-11-08,48367.1
5219,808,13070.66,2027-12-13,35296.44
5220,809,19803.75,2022-08-04,160086.48
5221,809,18056.62,2023-04-20,142029.86
5222,809,23836.24,2023-04-21,118193.62
5223,809,21153.38,2023-07-07,97040.24
5224,809,12470.07,2023-09-25,84570.17
5225,809,14878.66,2024-06-05,69691.51
5226,809,16021.13,2024-11-28,53670.38
5227,809,5618.14,2025-11-02,48052.24
5228,809,11852.17,2026-03-18,36200.07
5229,809,10322.36,2027-03-01,25877.71
5230,810,3363.76,2024-06-12,60407.4
5231,810,10407.8,2028-01-29,49999.6
5232,810,2582.51,2028-03-31,47417.09
5233,810,12059.59,2028-05-26,35357.5
5234,810,2148.2,2028-06-27,33209.3
5235,810,2031.57,2030-01-10,31177.73
5236,810,7961.22,2032-11-21,23216.51
5237,811,40045.25,2022-06-27,141497.34
5238,811,36236.73,2022-07-05,105260.61
5239,811,31193.67,2022-11-23,74066.94
5240,811,18083.76,2023-04-03,55983.18
5241,811,15670.74,2023-06-17,40312.44
5242,811,9364.95,2024-05-20,30947.49
5243,811,2420.01,2024-10-06,28527.48
5244,811,4340.58,2025-01-10,24186.9
5245,811,6814.24,2026-12-05,17372.66
5246,811,1039.83,2027-03-10,16332.83
5247,812,105980.23,2023-09-28,297935.72
5248,812,66797.07,2024-02-21,231138.65
5249,812,32254.83,2025-01-05,198883.82
5250,812,16807.72,2025-02-06,182076.1
5251,812,16970.73,2026-07-26,165105.37
5252,812,11280.34,2026-12-15,153825.03
5253,813,116124.78,2025-12-30,299242.21
5254,813,55805.23,2026-11-19,243436.98
5255,813,64503.39,2027-08-13,178933.59
5256,813,15174.34,2029-07-07,163759.25
5257,813,43072.21,2030-01-06,120687.04
5258,813,18560.4,2030-03-08,102126.64
5259,813,7250.19,2030-11-27,94876.45
5260,813,12058.49,2031-08-06,82817.96
5261,813,22540.48,2032-05-28,60277.48
5262,813,15659.01,2033-01-18,44618.47
5263,814,28940.4,2023-10-17,214121.22
5264,814,28679.13,2026-06-15,185442.09
5265,814,37982.99,2026-08-26,147459.1
5266,814,40411.11,2026-11-13,107047.99
5267,814,26302.79,2028-03-15,80745.2
5268,814,19413.01,2029-03-27,61332.19
5269,814,8627.75,2030-01-08,52704.44
5270,814,15572.3,2030-06-19,37132.14
5271,814,5043.26,2030-10-03,32088.88
5272,815,13892.59,2022-11-01,84796.96
5273,815,6575.04,2022-12-12,78221.92
5274,815,21540.36,2023-05-12,56681.56
5275,815,11657.5,2023-08-02,45024.06
5276,815,10865.24,2023-12-21,34158.82
5277,815,1803.3,2024-02-17,32355.52
5278,815,1654.44,2024-03-06,30701.08
5279,815,7941.74,2024-08-08,22759.34
5280,816,91242.95,2021-09-22,327588.38
5281,816,25059.66,2022-03-03,302528.72
5282,816,75207.52,2024-04-07,227321.2
5283,816,51724.18,2027-09-02,175597.02
5284,816,11473.0,2027-12-17,164124.02
5285,816,37483.37,2027-12-27,126640.65
5286,817,79673.7,2025-07-24,195553.31
5287,817,45150.63,2025-10-16,150402.68
5288,817,11516.58,2028-12-23,138886.1
5289,818,6562.46,2022-02-25,18986.97
5290,818,2453.34,2022-06-18,16533.63
5291,818,3296.96,2022-08-06,13236.67
5292,818,701.32,2023-11-18,12535.35
5293,818,2899.59,2023-12-14,9635.76
5294,819,24905.42,2025-03-01,135533.4
5295,819,8749.21,2025-05-18,126784.19
5296,819,15716.51,2025-07-04,111067.68
5297,819,23223.52,2025-10-28,87844.16
5298,819,5017.27,2025-12-31,82826.89
5299,819,20816.13,2026-01-04,62010.76
5300,819,15180.13,2026-02-09,46830.63
5301,819,7879.51,2026-02-09,38951.12
5302,820,22738.6,2023-03-20,120028.24
5303,820,13964.22,2023-09-09,106064.02
5304,820,19072.02,2023-09-10,86992.0
5305,820,8137.17,2029-08-22,78854.83
5306,821,48919.61,2025-03-05,176195.73
5307,821,22018.44,2026-05-12,154177.29
5308,821,42298.5,2029-05-04,111878.79
5309,821,16604.83,2029-07-13,95273.96
5310,821,12235.17,2029-09-08,83038.79
5311,822,47727.28,2022-10-26,189466.92
5312,822,26658.15,2026-08-12,162808.77
5313,822,32619.74,2026-09-03,130189.03
5314,823,116544.09,2023-10-28,318585.76
5315,823,67866.23,2024-04-09,250719.53
5316,823,69188.72,2024-04-29,181530.81
5317,823,24574.6,2024-05-01,156956.21
5318,823,43863.87,2024-08-25,113092.34
5319,824,634.69,2020-11-10,9372.31
5320,824,2084.55,2021-02-15,7287.76
5321,824,1673.76,2021-04-01,5614.0
5322,824,1543.95,2022-07-23,4070.05
5323,824,257.56,2025-02-02,3812.49
5324,824,832.97,2025-02-09,2979.52
5325,824,842.55,2026-07-28,2136.97
5326,825,30544.5,2021-10-06,131998.92
5327,825,14771.64,2021-10-13,117227.28
5328,825,24841.05,2021-12-02,92386.23
5329,825,22416.79,2022-02-22,69969.44
5330,825,9357.82,2022-07-06,60611.62
5331,825,7147.38,2022-10-01,53464.24
5332,825,5340.9,2023-02-09,48123.34
5333,825,7660.77,2023-03-05,40462.57
5334,825,3495.66,2023-04-18,36966.91
5335,825,2501.36,2023-05-08,34465.55
5336,826,50838.35,2024-04-09,210273.34
5337,826,31197.1,2024-10-31,179076.24
5338,826,13037.51,2025-05-05,166038.73
5339,826,20883.07,2025-09-08,145155.66
5340,826,25635.52,2026-10-28,119520.14
5341,827,55864.06,2024-11-28,277834.25
5342,827,72254.2,2027-01-07,205580.05
5343,827,43013.85,2027-06-10,162566.2
5344,827,21372.07,2027-10-13,141194.13
5345,827,23915.57,2028-12-10,117278.56
5346,827,32559.62,2031-12-21,84718.94
5347,828,1419.92,2026-03-19,4472.16
5348,828,1061.87,2027-11-09,3410.29
5349,828,650.14,2031-07-13,2760.15
5350,828,694.22,2034-02-25,2065.93
5351,829,31365.26,2024-08-03,142082.7
5352,829,40478.42,2025-05-08,101604.28
5353,829,29426.11,2025-08-07,72178.17
5354,829,20915.14,2026-07-14,51263.03
5355,829,7363.37,2026-10-25,43899.66
5356,829,9121.53,2028-04-15,34778.13
5357,829,7376.11,2028-05-29,27402.02
5358,829,1956.76,2029-02-20,25445.26
5359,829,5765.59,2031-08-16,19679.67
5360,830,112814.99,2022-02-12,368307.19
5361,830,27093.56,2022-07-11,341213.63
5362,830,25867.46,2023-09-19,315346.17
5363,830,56162.98,2025-03-19,259183.19
5364,830,20381.21,2025-12-21,238801.98
5365,831,29332.16,2021-10-21,78564.89
5366,831,10935.95,2021-11-27,67628.94
5367,831,4147.51,2021-12-24,63481.43
5368,831,8378.69,2022-02-19,55102.74
5369,831,7478.35,2022-10-10,47624.39
5370,831,11760.15,2022-12-31,35864.24
5371,831,8020.87,2023-01-10,27843.37
5372,831,3694.22,2023-02-16,24149.15
5373,831,3486.2,2023-03-02,20662.95
5374,832,11762.72,2023-03-14,61504.48
5375,832,3287.49,2023-04-05,58216.99
5376,832,7780.24,2023-04-14,50436.75
5377,832,14187.43,2023-06-05,36249.32
5378,832,2449.2,2023-07-04,33800.12
5379,832,9641.07,2023-08-16,24159.05
5380,832,2905.97,2023-12-06,21253.08
5381,832,2851.74,2024-01-21,18401.34
5382,833,60318.29,2024-08-22,215287.06
5383,833,44226.49,2026-11-06,171060.57
5384,833,21879.29,2027-05-04,149181.28
5385,833,26339.17,2028-03-20,122842.11
5386,833,6861.46,2028-12-23,115980.65
5387,833,11611.05,2028-12-27,104369.6
5388,833,21738.86,2029-02-25,82630.74
5389,833,14421.28,2029-04-12,68209.46
5390,834,61511.83,2025-03-21,365833.28
5391,834,27639.5,2026-08-31,338193.78
5392,834,18025.23,2027-08-27,320168.55
5393,834,52612.31,2028-06-19,267556.24
5394,834,45177.94,2030-11-21,222378.3
5395,834,11984.95,2030-12-31,210393.35
5396,834,24668.93,2031-02-14,185724.42
5397,835,7343.53,2021-08-28,53356.14
5398,835,15161.13,2021-08-30,38195.01
5399,835,8365.44,2021-12-20,29829.57
5400,835,5548.06,2021-12-22,24281.51
5401,835,1841.25,2022-11-05,22440.26
5402,835,1637.66,2022-12-09,20802.6
5403,835,6020.73,2023-03-16,14781.87
5404,836,11780.51,2022-04-14,41578.59
5405,836,6947.39,2022-07-08,34631.2
5406,836,9653.36,2022-07-11,24977.84
5407,836,2840.28,2022-09-20,22137.56
5408,836,5883.83,2022-10-27,16253.73
5409,836,3783.81,2022-12-07,12469.92
5410,836,761.41,2022-12-21,11708.51
5411,836,2306.95,2023-02-17,9401.56
5412,837,112762.93,2023-12-09,263413.37
5413,837,53770.09,2025-03-06,209643.28
5414,837,25126.38,2027-01-23,184516.9
5415,837,53419.26,2028-05-26,131097.64
5416,837,37705.37,2029-01-06,93392.27
5417,837,12043.06,2029-02-11,81349.21
5418,837,18701.03,2029-02-26,62648.18
5419,838,105960.88,2023-01-29,279937.06
5420,838,40470.39,2023-09-04,239466.67
5421,838,50583.87,2024-11-05,188882.8
5422,838,24496.04,2026-12-27,164386.76
5423,838,29285.3,2027-06-25,135101.46
5424,838,37022.86,2028-12-15,98078.6
5425,838,8300.16,2029-04-13,89778.44
5426,838,12264.89,2029-06-10,77513.55
5427,838,6112.36,2030-10-03,71401.19
5428,839,77421.73,2022-05-21,333240.18
5429,839,30983.26,2022-07-01,302256.92
5430,839,28660.13,2022-08-04,273596.79
5431,839,26683.15,2022-12-06,246913.64
5432,839,17960.54,2023-02-15,228953.1
5433,839,62170.72,2023-04-07,166782.38
5434,839,16357.01,2023-10-03,150425.37
5435,839,23411.85,2023-10-04,127013.52
5436,839,7123.15,2023-12-29,119890.37
5437,839,6577.0,2024-03-22,113313.37
5438,840,68524.4,2024-05-11,190658.95
5439,840,41421.2,2024-08-26,149237.75
5440,840,26656.53,2025-01-19,122581.22
5441,840,18564.07,2025-03-20,104017.15
5442,840,25935.5,2025-04-19,78081.65
5443,840,14174.95,2025-06-09,63906.7
5444,840,15967.44,2025-07-25,47939.26
5445,840,9358.4,2025-07-31,38580.86
5446,840,9028.12,2025-11-25,29552.74
5447,840,8583.66,2025-12-07,20969.08
5448,841,141851.82,2022-06-29,342384.04
5449,841,35897.62,2022-10-16,306486.42
5450,841,40902.35,2022-11-20,265584.07
5451,841,45413.63,2023-02-19,220170.44
5452,842,4421.91,2024-05-24,14255.12
5453,842,2176.97,2024-06-07,12078.15
5454,842,3599.79,2024-07-24,8478.36
5455,842,635.19,2024-10-14,7843.17
5456,842,961.15,2025-05-08,6882.02
5457,842,1676.01,2025-07-30,5206.01
5458,842,721.1,2025-10-11,4484.91
5459,842,310.74,2025-11-06,4174.17
5460,842,241.89,2026-01-22,3932.28
5461,842,254.31,2026-02-09,3677.97
5462,843,15090.29,2024-07-19,285045.31
5463,843,84553.88,2025-05-14,200491.43
5464,843,31416.19,2025-07-08,169075.24
5465,843,36328.84,2025-08-01,132746.4
5466,843,28969.89,2025-08-12,103776.51
5467,843,15488.13,2026-06-08,88288.38
5468,843,7533.89,2026-06-25,80754.49
5469,843,7165.11,2026-10-21,73589.38
5470,843,6153.51,2026-12-18,67435.87
5471,844,69128.98,2021-08-28,375084.05
5472,844,102553.64,2021-08-31,272530.41
5473,844,51544.37,2021-12-09,220986.04
5474,844,40484.83,2021-12-12,180501.21
5475,844,43387.76,2022-02-04,137113.45
5476,844,26999.95,2022-03-07,110113.5
5477,844,20257.72,2022-07-04,89855.78
5478,844,25236.7,2022-07-27,64619.08
5479,845,59936.12,2021-11-11,231681.81
5480,845,31433.29,2025-04-01,200248.52
5481,845,37006.17,2026-08-06,163242.35
5482,845,21065.87,2027-07-28,142176.48
5483,845,40433.12,2027-11-12,101743.36
5484,845,21423.49,2028-10-22,80319.87
5485,845,17724.61,2029-06-10,62595.26
5486,845,7426.3,2029-10-10,55168.96
5487,846,3557.75,2023-11-29,28235.54
5488,846,6209.58,2024-04-15,22025.96
5489,846,3432.71,2024-04-21,18593.25
5490,846,5166.56,2024-08-05,13426.69
5491,846,3311.22,2024-10-12,10115.47
5492,846,1932.03,2025-05-12,8183.44
5493,846,2248.02,2025-10-14,5935.42
5494,847,2329.42,2023-11-07,8996.97
5495,847,712.57,2025-01-16,8284.4
5496,847,1692.76,2025-10-14,6591.64
5497,847,1876.44,2028-01-08,4715.2
5498,847,415.83,2028-04-24,4299.37
5499,847,714.67,2030-08-29,3584.7
5500,847,236.01,2031-04-19,3348.69
5501,847,315.46,2031-12-22,3033.23
5502,848,53406.51,2026-09-12,364180.77
5503,848,60319.68,2027-03-07,303861.09
5504,848,25729.57,2028-02-20,278131.52
5505,848,31250.99,2030-07-13,246880.53
5506,848,55514.14,2030-09-15,191366.39
5507,848,10926.97,2031-08-04,180439.42
5508,849,147824.03,2023-04-07,346632.04
5509,849,85841.51,2023-06-04,260790.53
5510,849,33676.35,2023-06-04,227114.18
5511,849,22686.8,2023-06-08,204427.38
5512,849,21478.49,2023-06-28,182948.89
5513,849,9400.74,2024-10-14,173548.15
5514,849,13292.99,2024-11-26,160255.16
5515,849,26817.29,2025-10-12,133437.87
5516,849,14088.65,2025-12-02,119349.22
5517,850,72068.38,2023-01-27,288038.15
5518,850,51816.75,2023-05-13,236221.4
5519,850,17562.44,2024-02-05,218658.96
5520,850,11992.13,2024-03-04,206666.83
5521,850,58609.24,2024-07-26,148057.59
5522,850,42918.14,2024-10-31,105139.45
5523,851,20674.45,2024-05-04,129063.03
5524,851,36962.76,2024-08-01,92100.27
5525,851,25838.45,2024-10-05,66261.82
5526,851,19844.82,2024-12-06,46417.0
5527,851,6289.14,2025-02-17,40127.86
5528,851,3317.62,2025-05-18,36810.24
5529,851,6329.19,2025-07-16,30481.05
5530,851,6605.6,2025-10-11,23875.45
5531,851,5435.06,2027-07-14,18440.39
5532,852,65286.31,2022-07-16,325407.06
5533,852,79581.79,2022-12-15,245825.27
5534,852,35952.61,2024-04-24,209872.66
5535,852,49621.04,2024-12-16,160251.62
5536,852,41205.63,2026-03-09,119045.99
5537,852,14437.17,2026-11-05,104608.82
5538,852,24913.53,2026-11-25,79695.29
5539,852,18758.55,2029-01-08,60936.74
5540,852,7258.01,2029-09-17,53678.73
5541,853,60437.23,2023-07-25,280438.65
5542,853,15602.33,2024-05-14,264836.32
5543,853,31664.75,2025-05-05,233171.57
5544,854,66365.18,2027-01-17,254847.56
5545,854,40472.84,2027-02-10,214374.72
5546,854,29913.42,2027-10-12,184461.3
5547,854,29483.91,2027-12-27,154977.39
5548,854,10715.35,2028-04-05,144262.04
5549,854,34590.01,2028-05-28,109672.03
5550,855,52076.79,2023-10-14,156268.12
5551,855,32333.1,2024-04-02,123935.02
5552,855,16703.97,2024-11-25,107231.05
5553,855,8650.97,2026-05-14,98580.08
5554,855,23912.39,2026-09-16,74667.69
5555,856,74923.27,2027-06-29,299309.38
5556,856,45159.74,2028-09-13,254149.64
5557,856,67656.73,2029-01-05,186492.91
5558,856,35353.81,2029-04-18,151139.1
5559,856,38453.51,2029-10-12,112685.59
5560,856,17406.78,2030-01-03,95278.81
5561,856,23587.08,2030-04-23,71691.73
5562,856,9583.49,2031-01-06,62108.24
5563,856,10343.73,2031-05-26,51764.51
5564,857,51106.52,2022-10-30,267661.05
5565,857,28215.75,2022-12-09,239445.3
5566,857,18094.21,2024-05-22,221351.09
5567,857,23831.88,2024-10-12,197519.21
5568,857,22874.08,2026-06-19,174645.13
5569,857,13114.21,2029-06-18,161530.92
5570,858,4901.4,2024-04-18,47453.01
5571,858,8874.43,2026-02-11,38578.58
5572,858,5936.33,2027-04-15,32642.25
5573,858,8473.87,2027-10-31,24168.38
5574,859,37495.06,2026-06-29,112590.96
5575,859,6601.7,2030-08-17,105989.26
5576,859,27552.0,2032-01-09,78437.26
5577,859,18778.23,2032-03-05,59659.03
5578,860,22364.92,2023-06-13,69847.73
5579,860,10080.92,2025-08-01,59766.81
5580,860,14081.05,2028-02-03,45685.76
5581,860,7166.92,2028-06-30,38518.84
5582,860,3620.98,2030-01-20,34897.86
5583,860,7674.94,2030-07-05,27222.92
5584,861,117430.72,2022-09-26,309764.05
5585,861,65146.16,2023-08-02,244617.89
5586,861,23229.58,2023-08-30,221388.31
5587,861,47025.86,2024-07-21,174362.45
5588,861,47869.73,2024-09-11,126492.72
5589,861,23024.4,2024-12-15,103468.32
5590,861,10133.82,2025-01-30,93334.5
5591,861,7455.59,2025-04-14,85878.91
5592,861,21827.7,2026-05-19,64051.21
5593,862,48369.88,2022-04-21,225167.09
5594,862,54950.32,2022-05-06,170216.77
5595,862,13820.13,2022-06-29,156396.64
5596,862,26347.92,2022-07-13,130048.72
5597,862,31142.62,2023-04-23,98906.1
5598,862,29132.01,2023-10-01,69774.09
5599,862,9786.6,2024-10-26,59987.49
5600,862,6633.31,2025-03-04,53354.18
5601,863,132558.29,2021-12-05,343162.69
5602,863,72128.96,2022-05-14,271033.73
5603,863,75907.06,2022-06-18,195126.67
5604,863,30093.7,2022-07-22,165032.97
5605,863,31543.58,2022-08-11,133489.39
5606,863,37328.11,2022-11-20,96161.28
5607,863,8200.59,2022-12-07,87960.69
5608,863,15818.32,2023-03-10,72142.37
5609,864,62689.16,2024-04-10,389976.0
5610,864,56163.22,2025-04-15,333812.78
5611,864,18839.28,2025-12-21,314973.5
5612,864,35244.99,2026-12-18,279728.51
5613,864,74402.23,2027-01-13,205326.28
5614,864,36266.91,2027-05-02,169059.37
5615,864,10960.87,2027-11-25,158098.5
5616,864,21310.8,2029-12-10,136787.7
5617,864,32190.41,2030-03-04,104597.29
5618,865,18907.23,2025-05-29,49247.86
5619,865,7961.18,2031-07-04,41286.68
5620,865,3021.53,2031-07-08,38265.15
5621,866,57210.28,2020-11-08,147586.88
5622,866,38419.5,2021-04-10,109167.38
5623,866,21115.79,2021-09-30,88051.59
5624,866,17956.7,2021-11-24,70094.89
5625,866,3718.39,2022-08-05,66376.5
5626,866,13634.44,2022-12-18,52742.06
5627,867,102469.36,2022-03-21,337070.5
5628,867,63044.97,2025-02-14,274025.53
5629,867,52564.59,2025-03-01,221460.94
5630,867,38654.76,2025-08-15,182806.18
5631,867,29042.73,2025-09-27,153763.45
5632,867,41374.88,2025-10-31,112388.57
5633,867,10064.8,2026-04-08,102323.77
5634,867,28928.99,2026-04-30,73394.78
5635,867,5515.45,2026-05-27,67879.33
5636,868,45401.98,2025-12-09,220132.86
5637,868,24578.03,2026-07-19,195554.83
5638,868,23512.41,2026-10-19,172042.42
5639,869,61485.76,2022-04-10,160720.7
5640,869,18082.23,2022-04-13,142638.47
5641,869,26156.93,2022-09-03,116481.54
5642,870,33978.59,2023-02-28,275771.28
5643,870,19163.78,2023-10-09,256607.5
5644,870,32949.93,2023-12-12,223657.57
5645,870,32479.04,2024-01-29,191178.53
5646,870,17139.64,2026-09-24,174038.89
5647,870,33267.66,2027-06-22,140771.23
5648,870,34458.8,2028-07-14,106312.43
5649,871,13255.65,2024-09-20,41701.69
5650,871,4956.02,2025-01-13,36745.67
5651,871,10448.56,2026-02-13,26297.11
5652,871,5139.56,2026-10-09,21157.55
5653,872,50575.19,2024-02-27,257224.86
5654,872,49286.98,2024-04-05,207937.88
5655,872,36835.53,2024-05-15,171102.35
5656,872,31665.73,2024-07-13,139436.62
5657,872,13725.47,2024-08-26,125711.15
5658,872,13324.12,2025-06-30,112387.03
5659,872,14327.93,2027-06-03,98059.1
5660,872,17682.4,2029-02-03,80376.7
5661,872,7130.85,2032-10-23,73245.85
5662,873,91169.67,2024-04-21,289156.64
5663,873,38021.92,2024-05-22,251134.72
5664,873,62141.33,2024-11-20,188993.39
5665,873,47204.71,2024-11-26,141788.68
5666,873,17266.99,2025-05-22,124521.69
5667,873,8417.5,2025-05-29,116104.19
5668,873,30250.55,2025-10-27,85853.64
5669,873,18063.69,2025-11-13,67789.95
5670,873,9562.76,2026-02-04,58227.19
5671,874,9941.66,2022-04-25,77586.07
5672,874,16329.5,2022-09-22,61256.57
5673,874,14008.44,2023-02-14,47248.13
5674,874,10151.76,2023-04-16,37096.37
5675,874,5602.5,2023-09-13,31493.87
5676,874,4803.42,2024-08-29,26690.45
5677,875,71039.63,2022-01-14,286752.09
5678,875,64580.08,2022-01-21,222172.01
5679,875,33724.19,2023-04-16,188447.82
5680,875,13397.66,2023-10-13,175050.16
5681,875,44219.15,2024-03-23,130831.01
5682,875,8080.45,2025-02-07,122750.56
5683,875,23553.4,2026-02-21,99197.16
5684,876,19219.06,2021-08-15,194784.71
5685,876,44895.67,2021-10-16,149889.04
5686,876,34080.91,2021-11-10,115808.13
5687,876,23973.34,2022-02-02,91834.79
5688,876,17117.06,2022-06-09,74717.73
5689,876,7407.61,2022-09-06,67310.12
5690,876,7147.35,2022-09-30,60162.77
5691,876,11116.99,2022-10-11,49045.78
5692,876,14335.82,2023-01-30,34709.96
5693,877,25474.66,2021-01-14,110689.53
5694,877,15923.12,2021-02-04,94766.41
5695,877,9560.97,2021-05-10,85205.44
5696,877,8934.85,2021-07-01,76270.59
5697,877,20989.69,2022-05-07,55280.9
5698,877,12287.44,2023-01-27,42993.46
5699,877,4348.03,2023-03-17,38645.43
5700,877,7927.11,2023-07-05,30718.32
5701,877,8257.61,2024-08-19,22460.71
5702,878,31176.95,2025-01-27,203906.9
5703,878,42058.47,2026-02-12,161848.43
5704,878,23395.09,2026-03-04,138453.34
5705,879,35693.32,2021-10-30,279930.92
5706,879,26131.93,2021-11-20,253798.99
5707,879,25406.38,2021-12-21,228392.61
5708,879,60016.56,2022-03-11,168376.05
5709,879,13750.6,2022-08-04,154625.45
5710,879,41855.99,2022-08-12,112769.46
5711,879,11473.26,2023-05-19,101296.2
5712,879,29160.94,2023-07-11,72135.26
5713,879,12503.47,2023-09-27,59631.79
5714,879,14674.59,2023-10-04,44957.2
5715,880,83927.72,2025-02-21,304842.08
5716,880,17376.85,2025-04-25,287465.23
5717,880,84970.45,2027-06-13,202494.78
5718,880,38981.19,2028-11-16,163513.59
5719,880,9971.16,2029-05-01,153542.43
5720,880,34961.32,2029-05-02,118581.11
5721,880,9908.6,2029-06-03,108672.51
5722,880,17474.85,2029-10-21,91197.66
5723,880,20916.72,2029-11-24,70280.94
5724,881,26580.24,2023-01-06,315974.56
5725,881,68544.74,2024-06-01,247429.82
5726,881,19339.72,2025-03-31,228090.1
5727,882,63995.34,2025-07-19,401091.38
5728,882,31224.96,2026-01-29,369866.42
5729,882,80845.41,2026-07-29,289021.01
5730,882,45236.84,2026-11-09,243784.17
5731,882,55599.08,2027-04-02,188185.09
5732,882,30249.28,2028-05-22,157935.81
5733,882,9954.26,2028-07-13,147981.55
5734,882,41996.67,2028-09-14,105984.88
5735,883,66295.27,2023-08-09,223955.18
5736,883,23247.83,2024-01-28,200707.35
5737,883,53824.32,2025-07-05,146883.03
5738,883,11925.84,2026-08-30,134957.19
5739,883,38634.6,2026-11-13,96322.59
5740,883,6393.51,2027-02-18,89929.08
5741,884,67947.2,2025-10-22,401793.72
5742,884,88306.53,2027-03-27,313487.19
5743,884,54705.22,2028-07-19,258781.97
5744,884,67216.84,2030-02-23,191565.13
5745,884,40024.63,2030-07-31,151540.5
5746,885,37397.94,2026-05-21,361045.89
5747,885,97752.57,2026-06-16,263293.32
5748,885,17284.37,2026-11-25,246008.95
5749,885,62448.75,2027-03-10,183560.2
5750,885,39928.2,2027-04-02,143632.0
5751,886,22179.18,2023-12-17,85692.03
5752,886,25700.6,2024-10-15,59991.43
5753,886,3495.69,2025-01-04,56495.74
5754,886,16282.6,2025-04-16,40213.14
5755,886,4792.26,2025-09-23,35420.88
5756,886,7797.25,2026-01-21,27623.63
5757,886,3590.06,2028-04-08,24033.57
5758,887,13942.59,2023-01-14,147563.51
5759,887,39548.06,2025-06-03,108015.45
5760,887,12582.99,2030-04-23,95432.46
5761,888,7406.09,2025-06-03,21965.19
5762,888,4529.34,2025-09-13,17435.85
5763,888,1436.11,2027-02-13,15999.74
5764,888,3518.52,2027-08-17,12481.22
5765,888,861.57,2028-03-27,11619.65
5766,888,3441.85,2028-07-05,8177.8
5767,888,1660.02,2028-08-13,6517.78
5768,888,1684.69,2028-12-29,4833.09
5769,888,259.44,2029-01-15,4573.65
5770,888,742.47,2029-02-27,3831.18
5771,889,50540.11,2026-01-14,214892.04
5772,889,30102.07,2027-01-03,184789.97
5773,889,36646.31,2027-05-23,148143.66
5774,889,16779.68,2027-10-19,131363.98
5775,889,7469.74,2028-07-07,123894.24
5776,889,14154.84,2028-12-13,109739.4
5777,889,16985.81,2029-05-17,92753.59
5778,889,27018.04,2029-09-02,65735.55
5779,889,19003.12,2030-01-31,46732.43
5780,889,9714.22,2030-07-22,37018.21
5781,890,13589.29,2023-09-25,151428.86
5782,890,37918.64,2028-08-27,113510.22
5783,890,17422.1,2029-07-15,96088.12
5784,891,63093.9,2021-10-28,220913.1
5785,891,46324.23,2021-11-18,174588.87
5786,891,44829.23,2021-11-27,129759.64
5787,891,7117.25,2021-12-13,122642.39
5788,891,10186.42,2022-03-21,112455.97
5789,891,30959.68,2022-05-13,81496.29
5790,891,11556.12,2022-07-20,69940.17
5791,891,6857.32,2022-09-20,63082.85
5792,892,18605.3,2022-08-05,169255.51
5793,892,49532.01,2022-11-08,119723.5
5794,892,8199.95,2023-03-08,111523.55
5795,892,20162.46,2023-09-25,91361.09
5796,892,7163.93,2023-11-20,84197.16
5797,892,20948.99,2024-04-23,63248.17
5798,892,9457.44,2024-06-17,53790.73
5799,892,13786.45,2024-08-23,40004.28
5800,893,57624.02,2024-06-18,195073.59
5801,893,40360.73,2024-08-10,154712.86
5802,893,29123.49,2025-04-26,125589.37
5803,893,14982.71,2027-05-08,110606.66
5804,893,13571.54,2027-05-26,97035.12
5805,893,29001.86,2028-06-15,68033.26
5806,893,9294.21,2029-04-19,58739.05
5807,893,10005.26,2029-06-08,48733.79
5808,893,13981.21,2029-08-08,34752.58
5809,893,3479.47,2029-10-16,31273.11
5810,894,8866.4,2024-08-08,146442.06
5811,894,31358.85,2024-08-13,115083.21
5812,894,27935.26,2024-08-31,87147.95
5813,894,23642.89,2024-09-12,63505.06
5814,894,10247.84,2024-09-13,53257.22
5815,894,10385.92,2024-10-12,42871.3
5816,894,2739.13,2025-01-23,40132.17
5817,894,7993.9,2025-03-03,32138.27
5818,894,6868.19,2025-03-21,25270.08
5819,895,11399.82,2022-10-01,43585.65
5820,895,8495.39,2025-06-13,35090.26
5821,895,3709.14,2026-06-03,31381.12
5822,896,115047.99,2022-02-02,374277.15
5823,896,48836.66,2022-08-31,325440.49
5824,896,96045.4,2023-03-15,229395.09
5825,896,46548.81,2024-11-27,182846.28
5826,896,50164.14,2024-12-30,132682.14
5827,896,27179.66,2027-07-09,105502.48
5828,897,55206.25,2023-02-21,154503.34
5829,897,38266.19,2024-05-09,116237.15
5830,897,9326.35,2027-06-20,106910.8
5831,897,13013.44,2028-01-13,93897.36
5832,898,112983.32,2025-06-28,302395.86
5833,898,65958.89,2026-01-22,236436.97
5834,898,63160.5,2026-10-16,173276.47
5835,898,9204.67,2028-04-01,164071.8
5836,898,8283.31,2030-02-18,155788.49
5837,899,21689.1,2025-04-13,155576.76
5838,899,32330.01,2026-02-21,123246.75
5839,899,27709.52,2027-10-01,95537.23
5840,899,6648.11,2028-02-10,88889.12
5841,900,36597.72,2021-09-13,203135.36
5842,900,54550.22,2022-02-02,148585.14
5843,900,21255.74,2022-02-09,127329.4
5844,900,33893.64,2022-02-10,93435.76
5845,900,5936.89,2022-07-08,87498.87
5846,901,69369.06,2027-06-24,332689.43
5847,901,30039.8,2028-03-07,302649.63
5848,901,81910.77,2029-08-03,220738.86
5849,901,63972.23,2029-08-24,156766.63
5850,901,38955.71,2030-03-25,117810.92
5851,901,18464.86,2030-06-12,99346.06
5852,901,15559.71,2030-08-11,83786.35
5853,901,4206.04,2030-11-19,79580.31
5854,901,11984.68,2031-01-27,67595.63
5855,902,440.96,2025-10-26,1160.34
5856,902,87.63,2026-09-03,1072.71
5857,902,237.63,2027-03-17,835.08
5858,902,121.73,2027-08-03,713.35
5859,903,64324.25,2022-03-22,179288.21
5860,903,34002.71,2022-08-13,145285.5
5861,903,39039.18,2023-02-05,106246.32
5862,903,27395.81,2024-12-19,78850.51
5863,903,6606.43,2025-03-05,72244.08
5864,903,6106.5,2025-10-17,66137.58
5865,903,11478.47,2029-06-17,54659.11
5866,903,11777.85,2030-01-18,42881.26
5867,903,3096.25,2030-05-29,39785.01
5868,904,52570.8,2024-01-15,339226.95
5869,904,44708.14,2024-03-29,294518.81
5870,904,36843.08,2024-06-20,257675.73
5871,904,34527.1,2026-04-18,223148.63
5872,905,7766.77,2021-12-04,122528.19
5873,905,19957.0,2022-04-04,102571.19
5874,905,11574.93,2022-05-17,90996.26
5875,905,6315.44,2022-12-07,84680.82
5876,905,15999.07,2023-05-23,68681.75
5877,905,17242.43,2024-12-19,51439.32
5878,905,12336.54,2025-03-26,39102.78
5879,905,2868.43,2025-04-05,36234.35
5880,906,20226.86,2022-06-26,59184.55
5881,906,6536.87,2022-08-17,52647.68
5882,906,12344.53,2024-12-24,40303.15
5883,906,2694.28,2025-03-18,37608.87
5884,906,6164.65,2026-06-10,31444.22
5885,906,3854.08,2027-03-07,27590.14
5886,906,3278.65,2027-08-09,24311.49
5887,906,6325.66,2027-11-23,17985.83
5888,906,1332.76,2031-05-25,16653.07
5889,907,130038.48,2026-11-29,339227.41
5890,907,54219.14,2029-03-23,285008.27
5891,907,79483.75,2030-06-06,205524.52
5892,907,56639.44,2030-11-23,148885.08
5893,907,37390.12,2030-12-16,111494.96
5894,907,27097.42,2033-04-07,84397.54
5895,907,24551.15,2034-12-07,59846.39
5896,908,98225.11,2026-01-09,327995.79
5897,908,42441.18,2026-09-18,285554.61
5898,908,23261.3,2027-05-02,262293.31
5899,908,60121.53,2028-03-04,202171.78
5900,908,60437.49,2028-08-29,141734.29
5901,908,34093.07,2030-09-14,107641.22
5902,909,9052.38,2024-12-08,66430.09
5903,909,5590.23,2026-09-14,60839.86
5904,909,14008.05,2027-09-15,46831.81
5905,909,7560.43,2028-07-23,39271.38
5906,909,10906.52,2028-09-15,28364.86
5907,909,6504.9,2031-06-02,21859.96
5908,909,5728.48,2032-02-13,16131.48
5909,909,4181.96,2032-03-23,11949.52
5910,909,2014.99,2033-06-15,9934.53
5911,910,12903.76,2023-09-14,242470.18
5912,910,20396.83,2025-07-03,222073.35
5913,910,24504.86,2027-03-17,197568.49
5914,910,51822.25,2027-04-27,145746.24
5915,910,26524.62,2028-10-24,119221.62
5916,911,142921.71,2022-09-18,353780.49
5917,911,56679.23,2022-11-14,297101.26
5918,911,23829.33,2023-03-23,273271.93
5919,912,87543.04,2025-08-18,215899.91
5920,912,55282.79,2026-08-29,160617.12
5921,912,27785.54,2027-06-06,132831.58
5922,912,7526.43,2028-05-15,125305.15
5923,912,7756.5,2029-01-27,117548.65
5924,912,9766.66,2029-06-19,107781.99
5925,913,6689.4,2021-11-22,30415.41
5926,913,7593.45,2022-08-14,22821.96
5927,913,3189.93,2023-06-17,19632.03
5928,913,4504.1,2023-08-08,15127.93
5929,913,3853.26,2023-11-10,11274.67
5930,913,2835.33,2024-03-30,8439.34
5931,913,2272.57,2024-06-24,6166.77
5932,913,676.23,2024-06-28,5490.54
5933,914,123347.17,2021-08-18,313588.4
5934,914,19537.44,2021-09-15,294050.96
5935,914,68385.47,2022-12-21,225665.49
5936,914,58461.45,2024-03-06,167204.04
5937,914,15781.95,2024-07-24,151422.09
5938,914,33280.42,2025-02-04,118141.67
5939,914,33274.79,2030-10-04,84866.88
5940,915,72090.51,2022-01-18,276455.26
5941,915,41901.51,2022-03-19,234553.75
5942,915,13255.48,2022-06-05,221298.27
5943,915,54624.51,2023-02-04,166673.76
5944,915,8625.92,2023-03-19,158047.84
5945,915,42159.0,2023-09-05,115888.84
5946,915,14650.27,2024-01-06,101238.57
5947,915,9080.75,2024-01-31,92157.82
5948,915,16658.16,2024-08-21,75499.66
5949,916,72416.74,2023-01-06,345342.17
5950,916,88685.15,2023-11-29,256657.02
5951,916,64490.83,2025-11-12,192166.19
5952,917,23978.74,2023-01-15,92426.98
5953,917,11733.3,2023-09-11,80693.68
5954,917,4048.36,2024-08-09,76645.32
5955,917,7633.22,2026-02-28,69012.1
5956,917,13200.32,2026-10-07,55811.78
5957,917,9364.6,2028-03-10,46447.18
5958,917,2377.84,2028-10-22,44069.34
5959,917,8330.17,2029-04-07,35739.17
5960,917,5377.43,2030-02-26,30361.74
5961,917,6334.25,2030-09-14,24027.49
5962,918,90477.0,2025-10-02,309177.27
5963,918,38506.62,2025-10-05,270670.65
5964,918,71674.56,2026-01-12,198996.09
5965,918,53379.85,2026-02-10,145616.24
5966,918,43114.69,2027-12-22,102501.55
5967,918,15249.5,2027-12-30,87252.05
5968,918,18479.9,2028-09-28,68772.15
5969,918,11352.54,2028-11-09,57419.61
5970,919,48465.12,2022-06-13,423999.31
5971,919,107723.31,2023-01-20,316276.0
5972,919,42178.25,2023-07-20,274097.75
5973,920,16234.25,2025-04-11,49269.14
5974,920,5029.17,2025-05-26,44239.97
5975,920,6217.07,2025-07-09,38022.9
5976,920,5982.76,2025-08-22,32040.14
5977,920,5298.17,2025-09-15,26741.97
5978,921,40296.9,2020-10-20,105159.4
5979,921,14319.44,2023-10-29,90839.96
5980,921,14079.72,2025-04-20,76760.24
5981,921,9996.4,2026-09-18,66763.84
5982,922,20811.39,2022-05-23,102639.63
5983,922,25618.12,2022-10-03,77021.51
5984,922,17650.37,2025-05-11,59371.14
5985,923,76215.45,2023-01-24,196283.42
5986,923,32024.82,2023-03-24,164258.6
5987,923,10601.12,2023-04-05,153657.48
5988,923,9001.58,2023-07-01,144655.9
5989,923,32846.78,2023-11-24,111809.12
5990,923,31220.38,2024-11-28,80588.74
5991,923,4084.23,2025-02-23,76504.51
5992,923,21944.37,2025-06-12,54560.14
5993,923,16300.62,2026-04-25,38259.52
5994,924,29554.98,2020-09-29,389174.19
5995,924,110276.63,2021-05-18,278897.56
5996,924,32751.21,2021-07-06,246146.35
5997,924,22683.12,2021-08-15,223463.23
5998,924,59466.06,2022-07-30,163997.17
5999,924,32912.42,2022-09-29,131084.75
6000,924,38917.95,2023-04-03,92166.8
6001,925,37542.43,2021-06-22,223341.24
6002,925,41943.8,2021-10-20,181397.44
6003,925,49368.69,2022-04-14,132028.75
6004,925,39083.53,2022-04-27,92945.22
6005,925,15496.26,2022-11-05,77448.96
6006,925,6825.41,2022-11-05,70623.55
6007,925,9610.48,2022-11-08,61013.07
6008,925,8515.97,2023-02-12,52497.1
6009,926,17278.78,2021-10-02,51772.55
6010,926,11494.72,2022-02-15,40277.83
6011,926,2071.03,2022-08-11,38206.8
6012,926,3263.84,2022-10-15,34942.96
6013,926,2949.45,2022-10-16,31993.51
6014,926,5013.19,2023-03-04,26980.32
6015,926,1699.03,2023-03-13,25281.29
6016,926,5349.32,2023-05-30,19931.97
6017,926,3701.31,2023-06-21,16230.66
6018,927,67391.56,2021-12-04,176510.46
6019,927,20702.04,2023-11-29,155808.42
6020,927,38396.74,2023-12-07,117411.68
6021,927,15754.73,2025-02-01,101656.95
6022,928,69631.63,2025-04-19,301958.35
6023,928,24615.18,2025-05-25,277343.17
6024,928,67713.98,2026-04-12,209629.19
6025,928,19564.32,2026-08-06,190064.87
6026,928,12797.39,2026-10-10,177267.48
6027,928,48932.63,2026-10-20,128334.85
6028,928,28651.63,2026-12-22,99683.22
6029,928,5389.89,2027-05-31,94293.33
6030,928,15693.02,2027-08-28,78600.31
6031,928,19528.45,2027-11-25,59071.86
6032,929,31931.0,2026-06-04,284004.23
6033,929,35946.27,2026-08-07,248057.96
6034,929,74330.31,2026-09-11,173727.65
6035,929,25985.81,2026-09-12,147741.84
6036,930,39625.74,2024-03-03,305908.09
6037,930,67915.92,2027-01-10,237992.17
6038,930,42810.63,2030-01-25,195181.54
6039,930,11302.36,2030-10-23,183879.18
6040,931,30559.6,2025-02-22,398985.58
6041,931,51164.02,2025-03-24,347821.56
6042,931,102846.14,2025-10-14,244975.42
6043,931,21865.94,2025-11-24,223109.48
6044,931,52619.38,2026-05-15,170490.1
6045,931,12559.41,2026-07-10,157930.69
6046,931,13562.1,2027-07-02,144368.59
6047,931,39618.29,2029-01-14,104750.3
6048,931,23186.96,2030-07-28,81563.34
6049,931,24294.06,2031-08-25,57269.28
6050,932,39572.97,2028-12-29,273791.91
6051,932,41859.24,2029-01-17,231932.67
6052,932,22365.35,2029-05-01,209567.32
6053,932,33002.11,2031-06-09,176565.21
6054,932,9638.96,2032-04-16,166926.25
6055,932,40885.88,2032-08-09,126040.37
6056,933,8212.89,2023-08-14,55043.27
6057,933,7777.32,2024-06-02,47265.95
6058,933,12006.62,2025-02-26,35259.33
6059,933,9405.32,2025-06-13,25854.01
6060,933,3605.38,2025-07-08,22248.63
6061,933,4018.65,2026-05-28,18229.98
6062,933,1925.38,2027-03-08,16304.6
6063,933,4308.3,2028-07-02,11996.3
6064,933,1989.03,2029-02-23,10007.27
6065,934,37257.37,2027-10-09,122373.85
6066,934,13346.44,2028-07-25,109027.41
6067,934,24638.99,2028-09-26,84388.42
6068,934,16209.7,2028-10-21,68178.72
6069,934,3505.46,2028-11-15,64673.26
6070,934,11675.49,2029-02-04,52997.77
6071,934,14228.41,2030-08-01,38769.36
6072,934,4580.17,2030-12-27,34189.19
6073,935,34683.58,2023-08-18,399381.26
6074,935,85205.07,2023-10-31,314176.19
6075,935,61898.25,2024-01-08,252277.94
6076,935,36484.51,2024-07-27,215793.43
6077,935,30449.41,2024-09-13,185344.02
6078,935,43743.49,2025-02-12,141600.53
6079,935,32554.36,2025-03-07,109046.17
6080,935,20650.19,2025-07-27,88395.98
6081,935,16478.16,2025-11-07,71917.82
6082,935,19145.41,2026-11-06,52772.41
6083,936,105433.96,2026-04-07,318594.07
6084,936,27817.16,2026-05-02,290776.91
6085,936,71976.28,2027-05-30,218800.63
6086,936,62295.5,2027-10-04,156505.13
6087,936,19100.9,2028-09-11,137404.23
6088,936,17985.17,2028-11-02,119419.06
6089,936,23496.21,2028-12-22,95922.85
6090,936,9009.98,2029-02-24,86912.87
6091,936,7868.72,2031-01-04,79044.15
6092,936,18368.85,2031-07-28,60675.3
6093,937,29816.56,2025-08-10,160054.04
6094,937,35756.08,2026-10-27,124297.96
6095,937,20044.36,2026-12-27,104253.6
6096,937,18512.01,2028-01-24,85741.59
6097,937,17955.44,2029-06-01,67786.15
6098,938,77036.07,2023-04-30,383031.99
6099,938,55274.55,2023-05-04,327757.44
6100,938,65207.57,2023-09-14,262549.87
6101,938,40953.13,2023-11-08,221596.74
6102,938,22942.56,2023-11-08,198654.18
6103,939,16997.09,2022-09-22,299972.59
6104,939,48280.18,2023-01-02,251692.41
6105,939,68044.22,2023-01-26,183648.19
6106,939,22164.01,2023-04-27,161484.18
6107,939,29667.2,2023-05-18,131816.98
6108,939,26951.34,2023-08-31,104865.64
6109,939,26450.94,2023-12-29,78414.7
6110,939,18742.78,2024-01-18,59671.92
6111,939,9695.13,2024-06-27,49976.79
6112,939,10938.53,2024-09-02,39038.26
6113,940,51601.83,2022-01-26,300776.33
6114,940,31105.87,2023-11-25,269670.46
6115,940,52833.0,2024-01-09,216837.46
6116,940,16814.5,2024-07-06,200022.96
6117,940,50081.09,2025-03-04,149941.87
6118,940,25575.91,2030-04-12,124365.96
6119,940,31172.56,2030-06-17,93193.4
6120,941,91249.96,2022-12-25,217902.86
6121,941,48277.15,2023-03-20,169625.71
6122,941,17466.06,2023-07-24,152159.65
6123,941,8778.64,2023-07-25,143381.01
6124,941,33058.15,2023-09-26,110322.86
6125,941,31925.85,2023-10-31,78397.01
6126,942,13744.17,2022-03-10,42900.09
6127,942,11341.75,2022-05-02,31558.34
6128,942,3948.01,2022-09-21,27610.33
6129,942,6590.47,2022-12-13,21019.86
6130,942,4780.12,2022-12-30,16239.74
6131,942,1451.15,2022-12-31,14788.59
6132,942,1238.85,2023-01-04,13549.74
6133,942,776.44,2023-01-05,12773.3
6134,943,97659.41,2024-06-21,391740.31
6135,943,70594.26,2024-11-20,321146.05
6136,943,24848.98,2027-09-19,296297.07
6137,943,37861.51,2028-01-18,258435.56
6138,943,64460.63,2029-09-17,193974.93
6139,943,35056.03,2030-01-29,158918.9
6140,944,27251.16,2022-08-22,194602.71
6141,944,41197.52,2022-12-09,153405.19
6142,944,26037.35,2024-08-18,127367.84
6143,945,16821.34,2023-03-11,161339.12
6144,945,12969.37,2023-09-12,148369.75
6145,945,19491.69,2025-11-09,128878.06
6146,946,46276.61,2021-07-24,173554.05
6147,946,10307.12,2022-04-26,163246.93
6148,946,43024.87,2022-12-11,120222.06
6149,946,31097.54,2023-01-22,89124.52
6150,946,22650.88,2023-04-24,66473.64
6151,947,58648.11,2023-02-28,179549.88
6152,947,24988.51,2023-03-11,154561.37
6153,947,45429.04,2023-05-29,109132.33
6154,947,20076.95,2023-07-19,89055.38
6155,947,16917.17,2024-04-24,72138.21
6156,947,10422.5,2024-11-13,61715.71
6157,947,15651.7,2025-06-14,46064.01
6158,947,3135.14,2025-07-29,42928.87
6159,948,70646.39,2027-03-10,229954.48
6160,948,44630.01,2027-04-01,185324.47
6161,948,53139.74,2027-08-04,132184.73
6162,949,78124.25,2020-12-21,249491.57
6163,949,60223.99,2021-10-10,189267.58
6164,949,20539.8,2021-10-15,168727.78
6165,949,22000.61,2022-08-18,146727.17
6166,949,17087.09,2023-08-14,129640.08
6167,949,26606.71,2024-03-09,103033.37
6168,949,16857.42,2026-04-25,86175.95
6169,950,19952.71,2021-07-25,63453.89
6170,950,4998.55,2021-08-21,58455.34
6171,950,9112.67,2021-11-16,49342.67
6172,950,4808.12,2022-03-18,44534.55
6173,950,6486.52,2022-03-30,38048.03
6174,950,7064.41,2023-05-02,30983.62
6175,950,2342.84,2023-05-05,28640.78
6176,950,6446.87,2023-11-06,22193.91
6177,951,4355.89,2021-05-19,43453.01
6178,951,4586.17,2021-09-29,38866.84
6179,951,2995.82,2021-10-20,35871.02
6180,951,5406.17,2021-10-24,30464.85
6181,951,5603.47,2022-05-05,24861.38
6182,951,4714.37,2022-06-29,20147.01
6183,951,3715.8,2022-08-14,16431.21
6184,951,1487.85,2022-09-06,14943.36
6185,952,66021.58,2021-09-17,298676.25
6186,952,81651.7,2022-04-18,217024.55
6187,952,20205.31,2023-01-14,196819.24
6188,952,55097.75,2023-01-31,141721.49
6189,952,41886.3,2023-03-14,99835.19
6190,952,22670.13,2023-03-27,77165.06
6191,952,9721.62,2023-12-18,67443.44
6192,952,18871.33,2025-03-30,48572.11
6193,953,33940.91,2022-11-13,131404.3
6194,953,17660.33,2022-11-20,113743.97
6195,953,22878.79,2028-03-11,90865.18
6196,954,7057.28,2024-07-06,23249.62
6197,954,4466.48,2024-07-15,18783.14
6198,954,2266.25,2024-09-22,16516.89
6199,954,1058.95,2024-09-22,15457.94
6200,954,2205.11,2024-09-30,13252.83
6201,955,1087.0,2023-04-17,2625.88
6202,955,240.01,2026-11-17,2385.87
6203,955,167.01,2027-01-18,2218.86
6204,956,41616.23,2021-10-06,345988.07
6205,956,39314.1,2025-12-07,306673.97
6206,956,44452.01,2026-02-03,262221.96
6207,956,56782.77,2029-02-07,205439.19
6208,956,61579.77,2030-01-14,143859.42
6209,957,71364.44,2024-02-21,187354.21
6210,957,52386.33,2024-06-22,134967.88
6211,957,27165.35,2024-09-21,107802.53
6212,957,27640.73,2024-11-21,80161.8
6213,957,13747.9,2025-01-17,66413.9
6214,957,13335.62,2025-09-05,53078.28
6215,957,12111.07,2026-03-24,40967.21
6216,957,8961.9,2026-04-13,32005.31
6217,958,13094.52,2024-08-04,53846.63
6218,958,14313.43,2024-08-28,39533.2
6219,958,3732.93,2025-12-28,35800.27
6220,958,2406.03,2026-02-04,33394.24
6221,958,9544.69,2026-02-21,23849.55
6222,958,3986.12,2026-04-17,19863.43
6223,958,3400.84,2027-04-24,16462.59
6224,958,3070.99,2030-02-02,13391.6
6225,958,2311.31,2032-12-06,11080.29
6226,959,6277.16,2022-02-09,104572.57
6227,959,18987.34,2022-03-09,85585.23
6228,959,20644.5,2022-05-18,64940.73
6229,959,4244.55,2022-05-23,60696.18
6230,959,8439.12,2023-04-18,52257.06
6231,959,11159.9,2024-01-30,41097.16
6232,959,12078.01,2024-02-28,29019.15
6233,959,8390.41,2025-01-11,20628.74
6234,960,65425.19,2022-08-20,195037.73
6235,960,15068.01,2023-01-25,179969.72
6236,960,30034.18,2024-07-17,149935.54
6237,960,23869.69,2024-07-24,126065.85
6238,960,29579.4,2024-07-31,96486.45
6239,960,9380.14,2024-08-26,87106.31
6240,960,16998.75,2025-04-01,70107.56
6241,961,3521.65,2025-11-17,15990.64
6242,961,2651.79,2026-02-23,13338.85
6243,961,2269.87,2028-11-22,11068.98
6244,961,2976.64,2028-12-15,8092.34
6245,961,1996.97,2029-01-19,6095.37
6246,961,1733.08,2029-07-20,4362.29
6247,961,218.24,2029-10-19,4144.05
6248,961,1013.29,2032-03-10,3130.76
6249,961,691.1,2032-07-04,2439.66
6250,961,598.58,2032-07-16,1841.08
6251,962,10227.94,2025-07-14,38393.45
6252,962,4481.49,2026-06-04,33911.96
6253,962,5745.74,2028-04-06,28166.22
6254,962,1715.62,2029-02-09,26450.6
6255,963,35601.35,2024-01-25,157802.02
6256,963,14604.84,2025-05-19,143197.18
6257,963,25192.91,2027-10-21,118004.27
6258,963,19276.17,2029-02-17,98728.1
6259,963,23088.06,2029-06-24,75640.04
6260,963,4969.21,2032-06-28,70670.83
6261,963,15681.35,2032-10-24,54989.48
6262,964,11288.31,2028-05-02,171344.36
6263,964,26884.7,2029-06-07,144459.66
6264,964,33446.86,2030-09-24,111012.8
6265,965,16965.93,2024-09-20,92689.28
6266,965,18873.07,2027-06-25,73816.21
6267,965,8268.56,2028-03-14,65547.65
6268,965,4691.31,2029-05-09,60856.34
6269,965,17627.51,2029-08-12,43228.83
6270,965,3297.21,2029-09-18,39931.62
6271,965,2975.97,2030-01-06,36955.65
6272,966,1737.21,2022-02-12,8069.61
6273,966,1302.68,2022-05-11,6766.93
6274,966,1670.06,2022-05-12,5096.87
6275,966,281.52,2022-06-04,4815.35
6276,966,340.05,2022-06-09,4475.3
6277,966,633.63,2022-06-25,3841.67
6278,966,860.2,2022-07-10,2981.47
6279,967,92428.32,2023-12-20,295333.91
6280,967,23603.05,2024-03-13,271730.86
6281,967,54088.92,2024-05-18,217641.94
6282,967,13246.12,2026-02-07,204395.82
6283,967,29735.87,2026-03-23,174659.95
6284,968,17236.56,2021-12-10,177702.59
6285,968,9008.17,2023-01-08,168694.42
6286,968,29054.97,2023-03-29,139639.45
6287,968,31588.74,2024-01-25,108050.71
6288,968,7445.06,2027-01-31,100605.65
6289,969,38769.01,2022-06-20,272439.57
6290,969,48796.19,2023-04-08,223643.38
6291,969,62559.89,2023-12-13,161083.49
6292,969,27971.12,2023-12-31,133112.37
6293,970,8523.72,2023-09-14,20856.96
6294,970,3015.75,2024-10-09,17841.21
6295,970,3799.69,2024-12-19,14041.52
6296,970,1425.39,2026-03-06,12616.13
6297,971,6747.91,2021-05-03,18980.03
6298,971,1537.07,2021-07-02,17442.96
6299,971,3354.67,2021-10-05,14088.29
6300,971,2479.36,2021-11-22,11608.93
6301,971,1733.59,2022-04-04,9875.34
6302,971,1033.49,2022-07-09,8841.85
6303,971,1800.79,2023-01-03,7041.06
6304,972,49110.73,2025-03-14,120102.72
6305,972,23789.58,2026-08-11,96313.14
6306,972,17215.44,2026-12-10,79097.7
6307,972,18112.88,2027-03-29,60984.82
6308,972,11302.15,2027-11-10,49682.67
6309,972,7906.1,2030-10-30,41776.57
6310,972,6256.96,2031-02-06,35519.61
6311,972,7357.34,2031-03-29,28162.27
6312,973,10081.96,2024-07-21,65881.13
6313,973,15758.27,2026-06-27,50122.86
6314,973,13836.51,2027-10-27,36286.35
6315,973,3296.47,2027-12-17,32989.88
6316,973,6079.31,2030-03-05,26910.57
6317,973,2869.69,2030-04-07,24040.88
6318,973,1943.11,2030-07-16,22097.77
6319,974,26968.64,2024-02-01,251990.35
6320,974,58046.85,2027-11-07,193943.5
6321,974,21462.49,2028-01-20,172481.01
6322,975,49040.02,2024-09-26,189114.72
6323,975,26608.23,2025-05-17,162506.49
6324,975,11788.71,2025-07-06,150717.78
6325,975,11990.81,2025-08-08,138726.97
6326,975,41305.8,2027-03-09,97421.17
6327,975,5820.02,2028-02-04,91601.15
6328,975,23067.97,2028-09-06,68533.18
6329,975,16254.11,2030-07-14,52279.07
6330,976,12117.95,2024-09-13,31535.99
6331,976,6508.49,2028-03-29,25027.5
6332,976,4706.93,2028-07-03,20320.57
6333,976,2499.88,2029-06-07,17820.69
6334,976,3356.63,2030-06-29,14464.06
6335,977,98019.04,2021-09-19,381108.13
6336,977,87504.94,2022-01-10,293603.19
6337,977,81555.87,2023-11-08,212047.32
6338,977,24274.84,2023-12-10,187772.48
6339,977,54436.36,2028-06-14,133336.12
6340,977,27056.64,2028-10-14,106279.48
6341,978,80569.49,2024-02-16,248748.1
6342,978,54423.08,2025-09-27,194325.02
6343,978,45599.66,2026-02-24,148725.36
6344,978,32692.69,2026-06-24,116032.67
6345,978,10586.0,2028-01-30,105446.67
6346,978,24020.1,2029-06-05,81426.57
6347,979,26381.36,2022-01-11,291743.78
6348,979,27934.97,2022-06-30,263808.81
6349,979,28061.18,2022-07-17,235747.63
6350,979,23026.33,2022-12-14,212721.3
6351,979,23196.28,2024-01-19,189525.02
6352,979,36661.71,2024-08-03,152863.31
6353,980,58989.03,2022-06-04,340202.82
6354,980,76159.27,2023-02-12,264043.55
6355,980,68093.18,2025-02-08,195950.37
6356,980,34909.95,2025-04-15,161040.42
6357,980,17178.84,2028-04-27,143861.58
6358,980,10189.18,2029-09-27,133672.4
6359,980,10086.45,2030-01-02,123585.95
6360,981,71040.87,2025-07-03,199556.8
6361,981,41219.59,2025-07-31,158337.21
6362,981,12094.97,2025-09-28,146242.24
6363,981,19328.56,2026-04-25,126913.68
6364,981,12178.54,2026-05-15,114735.14
6365,981,8768.04,2026-08-13,105967.1
6366,981,20875.92,2027-01-17,85091.18
6367,981,12407.51,2027-08-17,72683.67
6368,981,17041.32,2028-07-09,55642.35
6369,981,6375.65,2029-02-16,49266.7
6370,982,7571.35,2022-07-14,77353.03
6371,982,22475.77,2024-10-07,54877.26
6372,982,16243.65,2026-01-08,38633.61
6373,982,9749.91,2026-03-13,28883.7
6374,983,42230.7,2021-01-21,256408.62
6375,983,74441.4,2021-01-25,181967.22
6376,983,16094.07,2021-04-10,165873.15
6377,983,47274.01,2021-08-07,118599.14
6378,984,16060.04,2020-12-30,282858.42
6379,984,49008.21,2023-07-06,233850.21
6380,984,55759.22,2024-08-03,178090.99
6381,984,32528.08,2025-01-13,145562.91
6382,984,12092.53,2025-01-30,133470.38
6383,984,30396.03,2026-01-18,103074.35
6384,984,18205.72,2026-12-22,84868.63
6385,984,11026.77,2028-09-07,73841.86
6386,985,36843.21,2023-06-28,222148.66
6387,985,31451.1,2023-07-18,190697.56
6388,985,39625.39,2023-10-11,151072.17
6389,985,31336.96,2024-02-13,119735.21
6390,985,13809.07,2024-11-06,105926.14
6391,985,6113.16,2024-12-15,99812.98
6392,985,24816.57,2025-07-13,74996.41
6393,985,5222.02,2025-12-06,69774.39
6394,986,35181.67,2024-09-24,306008.16
6395,986,66059.82,2027-09-24,239948.34
6396,986,26937.93,2029-07-26,213010.41
6397,986,58608.63,2029-09-09,154401.78
6398,987,10010.81,2021-03-26,31078.41
6399,987,6656.74,2021-04-29,24421.67
6400,987,5821.45,2021-05-30,18600.22
6401,987,3210.61,2021-08-01,15389.61
6402,987,4036.06,2021-10-14,11353.55
6403,987,3370.58,2021-12-28,7982.97
6404,987,1102.68,2022-08-05,6880.29
6405,987,411.02,2022-10-05,6469.27
6406,987,1912.98,2022-10-14,4556.29
6407,987,1091.09,2022-12-09,3465.2
6408,988,13958.7,2022-11-17,74717.44
6409,988,9755.8,2024-07-11,64961.64
6410,988,15677.23,2025-06-30,49284.41
6411,988,5502.22,2026-01-19,43782.19
6412,988,3398.91,2026-12-23,40383.28
6413,988,3870.72,2028-11-25,36512.56
6414,989,19379.66,2024-05-10,60081.94
6415,989,8375.62,2025-05-08,51706.32
6416,989,4803.84,2025-05-23,46902.48
6417,989,13844.45,2025-10-03,33058.03
6418,989,5742.85,2026-05-28,27315.18
6419,989,5034.71,2026-07-05,22280.47
6420,989,2866.13,2028-11-09,19414.34
6421,990,13564.11,2023-12-08,44427.41
6422,990,9027.27,2023-12-10,35400.14
6423,990,7077.85,2024-02-10,28322.29
6424,990,6785.12,2024-05-16,21537.17
6425,990,4813.42,2024-09-24,16723.75
6426,990,4363.82,2024-11-05,12359.93
6427,990,3620.59,2025-03-25,8739.34
6428,990,2304.89,2025-04-26,6434.45
6429,990,1489.13,2025-04-28,4945.32
6430,991,22734.5,2021-05-23,191441.91
6431,991,10936.13,2021-05-29,180505.78
6432,991,53842.33,2021-06-01,126663.45
6433,991,26172.19,2021-06-15,100491.26
6434,991,21257.17,2022-02-25,79234.09
6435,991,7022.19,2022-07-07,72211.9
6436,991,12061.79,2022-09-26,60150.11
6437,991,17599.61,2023-10-16,42550.5
6438,992,132612.83,2022-10-17,351986.81
6439,992,22268.67,2022-12-04,329718.14
6440,992,31687.56,2022-12-05,298030.58
6441,992,17641.72,2023-03-26,280388.86
6442,992,79597.52,2023-04-19,200791.34
6443,992,22946.59,2023-05-09,177844.75
6444,992,39399.74,2023-07-03,138445.01
6445,993,65800.93,2022-06-22,160751.76
6446,993,37927.04,2022-12-27,122824.72
6447,993,36063.08,2024-08-03,86761.64
6448,994,18399.49,2021-11-23,346492.8
6449,994,39447.9,2022-03-15,307044.9
6450,994,16715.68,2023-05-20,290329.22
6451,994,32849.77,2026-07-12,257479.45
6452,995,4713.55,2020-09-01,39064.25
6453,995,4982.62,2023-06-15,34081.63
6454,995,1785.5,2023-08-27,32296.13
6455,995,7553.8,2024-10-14,24742.33
6456,995,5122.53,2026-04-05,19619.8
6457,996,7357.01,2020-12-08,110448.7
6458,996,13051.58,2022-02-10,97397.12
6459,996,25887.83,2022-12-09,71509.29
6460,996,15658.28,2023-05-30,55851.01
6461,996,9529.21,2023-06-04,46321.8
6462,996,11254.82,2023-08-15,35066.98
6463,996,9105.22,2024-02-05,25961.76
6464,996,6027.93,2025-02-01,19933.83
6465,997,10696.33,2022-08-03,136002.87
6466,997,23640.25,2022-11-14,112362.62
6467,997,19497.61,2023-02-22,92865.01
6468,997,10665.24,2023-02-26,82199.77
6469,997,22591.7,2023-07-13,59608.07
6470,998,36022.44,2023-09-10,459761.97
6471,998,69373.46,2024-02-28,390388.51
6472,998,81041.41,2024-06-04,309347.1
6473,998,24766.53,2024-06-04,284580.57
6474,998,69683.42,2024-10-09,214897.15
6475,998,28540.93,2024-12-13,186356.22
6476,998,53683.36,2025-04-10,132672.86
6477,998,16656.31,2025-05-15,116016.55
6478,998,28361.38,2025-06-08,87655.17
6479,999,5149.14,2023-08-03,60494.49
6480,999,15807.7,2023-10-11,44686.79
6481,999,13304.02,2024-02-05,31382.77
6482,999,5977.5,2024-03-18,25405.27
6483,999,7578.23,2027-12-08,17827.04
6484,1000,58216.5,2021-02-09,213035.24
6485,1000,13869.03,2021-04-05,199166.21
6486,1000,14345.42,2021-05-28,184820.79
6487,1000,40983.49,2021-09-21,143837.3
6488,1000,33853.38,2022-11-29,109983.92
6489,1000,21122.67,2023-11-09,88861.25
6490,1000,17672.73,2023-12-16,71188.52
6491,1001,24816.95,2023-04-04,88933.9
6492,1001,6226.06,2023-11-03,82707.84
6493,1001,15580.55,2024-03-26,67127.29
6494,1001,4744.71,2024-06-30,62382.58
6495,1001,12274.09,2025-11-26,50108.49
6496,1002,1060.8,2023-02-05,8215.02
6497,1002,923.32,2024-04-28,7291.7
6498,1002,541.68,2024-05-03,6750.02
6499,1002,1666.94,2024-11-28,5083.08
6500,1002,276.29,2024-12-31,4806.79
6501,1002,792.43,2025-09-11,4014.36
6502,1002,483.01,2025-10-24,3531.35
6503,1002,258.33,2025-12-17,3273.02
6504,1002,384.44,2026-05-18,2888.58
6505,1002,616.49,2026-07-05,2272.09
6506,1003,11403.85,2022-04-06,137405.03
6507,1003,23945.47,2023-12-16,113459.56
6508,1003,31377.88,2027-01-21,82081.68
6509,1004,22658.04,2021-06-14,60615.93
6510,1004,15222.99,2022-12-18,45392.94
6511,1004,6556.95,2023-04-09,38835.99
6512,1004,6217.25,2025-03-21,32618.74
6513,1004,4215.83,2026-10-13,28402.91
6514,1004,6247.72,2027-01-16,22155.19
6515,1005,26491.35,2026-01-30,269925.47
6516,1005,57633.56,2026-09-11,212291.91
6517,1005,29775.63,2027-07-31,182516.28
6518,1005,17732.57,2027-08-23,164783.71
6519,1005,15273.69,2029-05-08,149510.02
6520,1005,11242.12,2029-07-28,138267.9
6521,1005,11464.79,2029-09-24,126803.11
6522,1005,15505.88,2029-11-20,111297.23
6523,1005,10048.04,2030-03-15,101249.19
6524,1005,19543.87,2031-07-30,81705.32
6525,1006,22076.09,2024-11-15,87943.57
6526,1006,8664.22,2025-01-12,79279.35
6527,1006,10600.74,2025-02-17,68678.61
6528,1006,12854.27,2025-02-18,55824.34
6529,1006,4311.14,2025-03-17,51513.2
6530,1006,5579.83,2025-05-01,45933.37
6531,1006,2328.37,2025-07-17,43605.0
6532,1006,3466.7,2025-07-21,40138.3
6533,1006,2812.48,2025-08-29,37325.82
6534,1007,30469.2,2025-11-30,462820.58
6535,1007,104803.23,2027-04-18,358017.35
6536,1007,37469.33,2027-09-14,320548.02
6537,1007,89208.69,2028-03-11,231339.33
6538,1007,44817.75,2028-04-01,186521.58
6539,1008,52352.32,2023-09-12,361768.1
6540,1008,71557.22,2026-07-09,290210.88
6541,1008,23353.97,2030-06-26,266856.91
6542,1008,16257.05,2030-10-22,250599.86
6543,1009,6144.91,2025-06-29,30206.02
6544,1009,7898.8,2025-12-13,22307.22
6545,1009,3522.78,2027-01-30,18784.44
6546,1009,4468.37,2027-03-27,14316.07
6547,1009,3670.08,2027-11-10,10645.99
6548,1009,1361.54,2027-12-28,9284.45
6549,1009,2615.61,2028-01-17,6668.84
6550,1009,1669.26,2028-08-20,4999.58
6551,1009,495.38,2028-12-06,4504.2
6552,1009,583.52,2029-01-17,3920.68
6553,1010,47175.66,2023-08-18,416084.71
6554,1010,115395.67,2024-05-20,300689.04
6555,1010,47236.13,2024-10-26,253452.91
6556,1010,53597.93,2025-01-18,199854.98
6557,1010,24375.96,2025-03-30,175479.02
6558,1010,50056.58,2025-04-17,125422.44
6559,1010,12913.73,2025-05-12,112508.71
6560,1010,6001.39,2025-06-14,106507.32
6561,1011,85365.21,2024-02-01,214534.09
6562,1011,15892.7,2024-04-10,198641.39
6563,1011,24782.46,2024-07-03,173858.93
6564,1011,38694.98,2024-08-23,135163.95
6565,1011,23969.01,2024-11-07,111194.94
6566,1011,26641.59,2025-09-10,84553.35
6567,1011,5040.85,2026-03-20,79512.5
6568,1011,23466.63,2027-05-16,56045.87
6569,1012,19357.93,2021-04-07,248635.62
6570,1012,65784.69,2024-07-04,182850.93
6571,1012,34899.03,2028-11-14,147951.9
6572,1012,33899.2,2029-02-05,114052.7
